0 0 4096 4096 0 
1 0 4096 2048 2048 
2 2048 4096 4096 2048 
3 0 2048 2048 0 
13 0 2048 1024 1024 
14 1024 2048 2048 1024 
15 0 1024 1024 0 
61 0 1024 512 512 73 74 75 76 77 78 135 139 140 141 142 143 144 201 202 203 204 
62 512 1024 1024 512 79 80 81 82 83 84 85 86 145 146 147 148 149 150 151 152 
63 0 512 512 0 1 2 3 136 137 138 207 
64 512 512 1024 0 4 5 6 7 32 33 34 35 36 37 38 208 
16 1024 1024 2048 0 
65 1024 1024 1536 512 87 88 89 90 91 92 93 94 153 154 155 156 157 158 159 160 
66 1536 1024 2048 512 95 96 97 98 99 100 101 102 161 162 163 164 165 166 167 168 
67 1024 512 1536 0 8 9 10 11 39 40 41 42 43 44 45 46 
68 1536 512 2048 0 12 13 14 15 47 48 49 50 51 52 53 54 
4 2048 2048 4096 0 
17 2048 2048 3072 1024 
18 3072 2048 4096 1024 
19 2048 1024 3072 0 
77 2048 1024 2560 512 103 104 105 106 107 108 109 110 169 170 171 172 173 174 175 176 
78 2560 1024 3072 512 111 112 113 114 115 116 117 118 177 178 179 180 181 182 183 184 
79 2048 512 2560 0 16 17 18 19 55 56 57 58 59 60 61 62 
80 2560 512 3072 0 20 21 22 23 63 64 65 66 67 68 69 70 
20 3072 1024 4096 0 
81 3072 1024 3584 512 119 120 121 122 123 124 125 126 185 186 187 188 189 190 191 192 
82 3584 1024 4096 512 127 128 129 130 131 132 133 134 193 194 195 196 197 198 199 200 
83 3072 512 3584 0 24 25 26 27 71 72 
84 3584 512 4096 0 28 29 30 31 205 206 
<End>