0 0 4096 4096 0 
1 0 4096 2048 2048 
2 2048 4096 4096 2048 
3 0 2048 2048 0 
13 0 2048 1024 1024 
14 1024 2048 2048 1024 
15 0 1024 1024 0 
61 0 1024 512 512 
62 512 1024 1024 512 
63 0 512 512 0 1 2 3 4 5 6 1 2 3 4 5 6 1 2 3 4 5 6 
64 512 512 1024 0 7 8 9 10 11 7 8 9 10 11 7 8 9 10 11 
16 1024 1024 2048 0 
65 1024 1024 1536 512 
66 1536 1024 2048 512 
67 1024 512 1536 0 12 13 14 15 16 12 13 14 15 16 12 13 14 15 16 
68 1536 512 2048 0 17 18 19 20 21 22 17 18 19 20 21 22 17 18 19 20 21 22 
4 2048 2048 4096 0 
17 2048 2048 3072 1024 
18 3072 2048 4096 1024 
19 2048 1024 3072 0 
77 2048 1024 2560 512 
78 2560 1024 3072 512 
79 2048 512 2560 0 23 24 25 26 27 23 24 25 26 27 23 24 25 26 27 
80 2560 512 3072 0 28 29 30 31 32 28 29 30 31 32 28 29 30 31 32 
20 3072 1024 4096 0 
81 3072 1024 3584 512 
82 3584 1024 4096 512 
83 3072 512 3584 0 33 34 35 36 37 38 33 34 35 36 37 38 33 34 35 36 37 38 
84 3584 512 4096 0 39 40 41 42 44 39 40 41 42 44 39 40 41 42 44 
<End>