0 0 8192 8192 0 
1 0 8192 4096 4096 
2 4096 8192 8192 4096 
3 0 4096 4096 0 
13 0 4096 2048 2048 
14 2048 4096 4096 2048 
15 0 2048 2048 0 
61 0 2048 1024 1024 
62 1024 2048 2048 1024 
63 0 1024 1024 0 
253 0 1024 512 512 
254 512 1024 1024 512 
255 0 512 512 0 3 4 5 6 7 8 9 10 3 4 5 6 7 8 9 10 131 3 4 5 6 7 8 9 10 131 132 
256 512 512 1024 0 11 12 13 14 15 16 17 18 11 12 13 14 15 16 17 18 11 12 13 14 15 16 17 18 
64 1024 1024 2048 0 
257 1024 1024 1536 512 
258 1536 1024 2048 512 
259 1024 512 1536 0 19 20 21 22 23 24 25 26 19 20 21 22 23 24 25 26 19 20 21 22 23 24 25 26 
260 1536 512 2048 0 27 28 29 30 31 32 33 34 27 28 29 30 31 32 33 34 27 28 29 30 31 32 33 34 
16 2048 2048 4096 0 
65 2048 2048 3072 1024 
66 3072 2048 4096 1024 
67 2048 1024 3072 0 
269 2048 1024 2560 512 
270 2560 1024 3072 512 
271 2048 512 2560 0 35 36 37 38 39 40 41 42 35 36 37 38 39 40 41 42 35 36 37 38 39 40 41 42 
272 2560 512 3072 0 43 44 45 46 47 48 49 50 43 44 45 46 47 48 49 50 43 44 45 46 47 48 49 50 
68 3072 1024 4096 0 
273 3072 1024 3584 512 
274 3584 1024 4096 512 
275 3072 512 3584 0 51 52 53 54 55 56 57 58 51 52 53 54 55 56 57 58 51 52 53 54 55 56 57 58 
276 3584 512 4096 0 2 2 59 60 61 62 63 64 65 66 2 59 60 61 62 63 64 65 66 2 59 60 61 62 63 64 65 66 
4 4096 4096 8192 0 
17 4096 4096 6144 2048 
18 6144 4096 8192 2048 
19 4096 2048 6144 0 
77 4096 2048 5120 1024 
78 5120 2048 6144 1024 
79 4096 1024 5120 0 
317 4096 1024 4608 512 
318 4608 1024 5120 512 
319 4096 512 4608 0 67 68 69 70 71 72 73 74 67 68 69 70 71 72 73 74 67 68 69 70 71 72 73 74 
320 4608 512 5120 0 75 76 77 78 79 80 81 82 75 76 77 78 79 80 81 82 75 76 77 78 79 80 81 82 
80 5120 1024 6144 0 
321 5120 1024 5632 512 
322 5632 1024 6144 512 
323 5120 512 5632 0 83 84 85 86 87 88 89 90 83 84 85 86 87 88 89 90 83 84 85 86 87 88 89 90 
324 5632 512 6144 0 91 92 93 94 95 96 97 98 91 92 93 94 95 96 97 98 91 92 93 94 95 96 97 98 
20 6144 2048 8192 0 
81 6144 2048 7168 1024 
82 7168 2048 8192 1024 
83 6144 1024 7168 0 
333 6144 1024 6656 512 
334 6656 1024 7168 512 
335 6144 512 6656 0 99 100 101 102 103 104 105 106 99 100 101 102 103 104 105 106 99 100 101 102 103 104 105 106 
336 6656 512 7168 0 107 108 109 110 111 112 113 114 107 108 109 110 111 112 113 114 107 108 109 110 111 112 113 114 
84 7168 1024 8192 0 
337 7168 1024 7680 512 
338 7680 1024 8192 512 
339 7168 512 7680 0 115 116 117 118 119 120 121 122 115 116 117 118 119 120 121 122 115 116 117 118 119 120 121 122 
340 7680 512 8192 0 1 1 123 124 125 126 127 128 129 130 1 123 124 125 126 127 128 129 130 1 123 124 125 126 127 128 129 130 
<End>