0 0 8192 8192 0 
1 0 8192 4096 4096 
5 0 8192 2048 6144 
6 2048 8192 4096 6144 
7 0 6144 2048 4096 
8 2048 6144 4096 4096 
33 2048 6144 3072 5120 
34 3072 6144 4096 5120 
35 2048 5120 3072 4096 
141 2048 5120 2560 4608 
142 2560 5120 3072 4608 
143 2048 4608 2560 4096 
144 2560 4608 3072 4096 660 
36 3072 5120 4096 4096 
145 3072 5120 3584 4608 
146 3584 5120 4096 4608 
147 3072 4608 3584 4096 329 330 331 332 333 334 335 336 337 338 
148 3584 4608 4096 4096 
2 4096 8192 8192 4096 
3 0 4096 4096 0 
13 0 4096 2048 2048 
14 2048 4096 4096 2048 
57 2048 4096 3072 3072 
229 2048 4096 2560 3584 1456 1457 1458 1459 1460 1461 1462 1463 1464 1465 1466 1467 1468 1469 1508 1509 1510 1511 1512 1513 1514 1515 1516 1517 1518 1519 1520 1521 
230 2560 4096 3072 3584 307 308 309 310 311 312 313 314 315 316 317 318 319 320 321 322 323 324 399 429 435 445 1596 1607 1608 1609 1612 1613 1616 1617 1620 1621 1624 1625 1628 1629 1630 1631 1632 1635 1644 1651 
231 2048 3584 2560 3072 1440 1441 1442 1443 1444 1445 1446 1447 1448 1449 1450 1451 1452 1453 1454 1455 1492 1493 1494 1495 1496 1497 1498 1499 1500 1501 1502 1503 1504 1505 1506 1507 
232 2560 3584 3072 3072 292 293 294 295 296 297 298 299 300 301 302 303 304 305 306 444 659 1247 1248 1249 1250 1251 1252 1253 1254 1255 1256 1373 1374 1377 1378 1381 1382 1385 1386 1389 1390 1393 1394 1397 1398 1401 1402 1405 1406 1409 1410 1555 1560 1561 1563 1564 1565 1566 1567 1568 1569 1570 1571 1572 1573 1574 1575 1576 1577 1578 1579 1580 1583 1584 1585 1586 1587 1588 1589 1592 1593 1597 1598 1599 1602 1603 1606 
58 3072 4096 4096 3072 
233 3072 4096 3584 3584 325 326 327 328 339 340 1610 1611 1614 1615 1618 1619 1622 1623 1626 1627 1633 1634 1636 1637 1638 1639 1640 1641 1642 1643 1645 1646 1647 1648 1649 1650 1652 1653 1654 1655 1656 1657 1658 1659 1660 1661 1662 1663 1664 1665 1666 1667 1668 1669 1670 1671 1672 1673 1674 1675 1680 1681 1682 1683 1709 1710 1711 1712 1713 1714 1715 1716 1717 1718 
234 3584 4096 4096 3584 341 342 343 344 345 346 347 348 349 350 351 352 353 354 355 356 357 358 359 360 361 362 363 364 365 366 430 431 447 448 661 1676 1677 1678 1679 1719 1720 1721 1722 1723 1724 1725 1726 1727 1728 1729 1730 1731 1732 1733 1734 1735 1736 1737 1738 1739 1740 1741 1742 1743 1744 1745 
235 3072 3584 3584 3072 1375 1376 1379 1380 1383 1384 1387 1388 1391 1392 1395 1396 1399 1400 1403 1404 1407 1408 1411 1412 1581 1582 1590 1591 1594 1595 1600 1601 1604 1605 1701 1702 1703 1704 1705 1706 1707 1708 1746 1747 1748 1749 1750 1751 1752 1753 
236 3584 3584 4096 3072 367 368 369 370 371 372 373 374 375 380 381 446 455 456 457 662 
59 2048 3072 3072 2048 
237 2048 3072 2560 2560 1424 1425 1426 1427 1428 1429 1430 1431 1432 1433 1434 1435 1436 1437 1438 1439 1476 1477 1478 1479 1480 1481 1482 1483 1484 1485 1486 1487 1488 1489 1490 1491 
238 2560 3072 3072 2560 269 270 271 272 273 274 275 276 277 278 279 280 281 282 283 284 285 286 287 288 289 290 291 428 443 454 1231 1232 1233 1234 1235 1236 1237 1238 1239 1240 1241 1242 1243 1244 1245 1246 1309 1310 1313 1314 1317 1318 1321 1322 1325 1326 1329 1330 1333 1334 1337 1338 1341 1342 1345 1346 1349 1350 1353 1354 1357 1358 1361 1362 1365 1366 1369 1370 1553 1554 1556 1557 1558 1559 
239 2048 2560 2560 2048 229 230 231 232 233 234 235 236 237 238 657 665 1174 1175 1176 1177 1178 1181 1422 1423 1474 1475 1522 1535 1541 1547 
240 2560 2560 3072 2048 249 250 251 252 253 254 255 256 257 258 259 260 261 262 263 264 265 266 267 268 427 438 439 658 1213 1214 1215 1216 1217 1218 1219 1222 1223 1224 1225 1226 1227 1228 1229 1230 1257 1258 1261 1262 1265 1266 1269 1270 1273 1274 1277 1278 1281 1282 1285 1286 1289 1290 1293 1294 1297 1298 1301 1302 1305 1306 1413 1414 1417 1418 1419 1420 1421 1470 1471 1523 1524 1525 1526 1527 1528 1529 1530 1531 1532 1533 1534 1536 1537 1538 1539 1540 1542 1543 1544 1545 1546 1548 1549 1550 1551 1552 
60 3072 3072 4096 2048 
241 3072 3072 3584 2560 1311 1312 1315 1316 1319 1320 1323 1324 1327 1328 1331 1332 1335 1336 1339 1340 1343 1344 1347 1348 1351 1352 1355 1356 1359 1360 1363 1364 1367 1368 1371 1372 1693 1694 1695 1696 1697 1698 1699 1700 1754 1755 1756 1757 1758 1759 1760 1761 1762 
242 3584 3072 4096 2560 376 377 378 379 382 383 384 385 386 387 388 389 390 391 392 393 394 458 459 460 461 
243 3072 2560 3584 2048 1220 1221 1259 1260 1263 1264 1267 1268 1271 1272 1275 1276 1279 1280 1283 1284 1287 1288 1291 1292 1295 1296 1299 1300 1303 1304 1307 1308 1415 1416 1472 1473 1684 1685 1686 1687 1688 1689 1690 1691 1692 1763 1764 1765 1766 1767 
244 3584 2560 4096 2048 462 463 464 465 466 467 468 469 475 476 477 478 479 480 481 482 488 489 490 491 492 493 494 495 496 497 498 499 500 501 502 557 558 559 560 561 562 563 564 
15 0 2048 2048 0 
61 0 2048 1024 1024 
62 1024 2048 2048 1024 
249 1024 2048 1536 1536 
250 1536 2048 2048 1536 202 203 204 205 206 207 208 209 210 211 212 213 214 215 216 217 218 219 220 221 222 223 224 426 436 437 442 656 718 719 722 723 724 725 726 727 1072 1073 1080 1081 1088 1089 1090 1091 1092 1099 1106 1113 1120 1127 1128 1129 1130 1136 1137 1143 1144 1145 1151 1152 1153 1154 1155 1156 1157 1162 1163 1771 
251 1024 1536 1536 1024 
252 1536 1536 2048 1024 188 189 191 192 193 194 195 196 197 198 199 200 201 395 397 398 423 424 425 433 434 441 453 667 702 703 704 705 706 707 708 709 710 711 712 713 714 715 716 717 728 729 734 735 736 737 742 
63 0 1024 1024 0 
253 0 1024 512 512 
254 512 1024 1024 512 
255 0 512 512 0 1 2 3 4 5 6 7 8 29 30 31 32 33 34 35 36 57 58 59 60 61 62 63 64 65 66 67 68 69 70 71 72 93 94 95 96 97 98 99 100 101 102 108 109 404 405 408 409 411 412 
256 512 512 1024 0 9 10 11 12 13 14 15 16 37 38 39 40 41 42 43 44 73 74 75 76 77 78 79 80 81 82 83 84 85 86 87 88 103 104 105 106 107 110 111 122 123 406 407 410 413 414 415 416 417 440 666 
64 1024 1024 2048 0 
257 1024 1024 1536 512 
258 1536 1024 2048 512 165 166 167 168 169 170 171 172 173 174 175 176 177 178 179 180 181 182 183 184 185 186 187 190 396 420 421 422 432 691 692 693 694 695 696 697 698 699 700 701 720 721 730 731 732 733 738 739 740 741 883 890 891 892 893 900 901 902 903 910 911 912 919 920 921 
259 1024 512 1536 0 17 18 19 20 21 22 23 45 46 47 48 49 50 51 89 90 91 92 124 125 126 127 128 129 132 133 134 135 136 137 138 139 140 141 142 143 144 400 401 402 403 449 450 451 
260 1536 512 2048 0 24 25 26 27 28 52 53 54 55 56 112 113 114 115 116 117 118 119 120 121 130 131 145 146 147 148 149 150 151 152 153 154 155 156 157 158 159 160 161 162 163 164 418 419 452 668 669 670 671 672 673 674 675 676 677 678 679 680 681 682 683 684 685 686 687 688 689 690 749 753 757 761 762 766 767 771 772 776 777 781 782 783 
16 2048 2048 4096 0 
65 2048 2048 3072 1024 
261 2048 2048 2560 1536 225 226 227 228 1060 1061 1062 1063 1064 1065 1066 1067 1068 1069 1070 1071 1074 1075 1076 1077 1078 1079 1082 1083 1084 1085 1086 1087 1093 1094 1095 1096 1097 1098 1100 1101 1102 1103 1104 1105 1107 1108 1109 1110 1111 1112 1114 1115 1116 1117 1118 1119 1121 1122 1123 1124 1125 1126 1131 1132 1133 1134 1135 1138 1139 1140 1141 1142 1146 1147 1148 1149 1150 1158 1159 1160 1161 1164 1165 1166 1167 1168 1169 1170 1171 1172 1173 1179 1180 1182 1183 1184 1185 1186 1187 1188 1194 1195 1196 1197 1768 1769 
262 2560 2048 3072 1536 239 240 241 242 243 244 245 246 247 248 1189 1190 1191 1192 1193 1198 1199 1200 1201 1202 1203 1204 1205 1208 1209 1210 
263 2048 1536 2560 1024 964 965 966 967 968 969 970 971 972 973 974 975 976 977 978 979 980 981 982 983 984 985 986 987 988 989 990 991 992 993 994 995 996 997 998 999 1000 1001 1002 1003 1004 1005 1006 1007 1008 1009 1010 1011 1012 1013 1014 1015 1016 1017 1018 1019 1020 1021 1022 1023 1024 1025 1026 1027 1028 1029 1030 1031 1032 1033 1034 1035 1036 1037 1038 1039 1040 1041 1042 1043 1044 1045 1046 1047 1048 1049 1050 1051 1052 1053 1054 1055 1056 1057 1058 1059 
264 2560 1536 3072 1024 
66 3072 2048 4096 1024 
265 3072 2048 3584 1536 1206 1207 1211 1212 
266 3584 2048 4096 1536 
267 3072 1536 3584 1024 
268 3584 1536 4096 1024 
67 2048 1024 3072 0 
269 2048 1024 2560 512 853 854 855 856 857 858 859 860 861 862 863 864 865 866 867 868 869 870 871 872 873 874 875 876 877 878 879 880 881 882 884 885 886 887 888 889 894 895 896 897 898 899 904 905 906 907 908 909 913 914 915 916 917 918 922 923 924 925 926 927 928 929 930 931 932 933 934 935 936 937 938 939 940 941 942 943 944 945 946 947 948 949 950 951 952 953 954 955 956 957 958 959 960 961 962 963 
270 2560 1024 3072 512 
271 2048 512 2560 0 743 744 745 746 747 748 750 751 752 754 755 756 758 759 760 763 764 765 768 769 770 773 774 775 778 779 780 784 785 786 787 788 789 790 791 792 793 794 795 796 797 798 799 800 801 802 803 804 805 806 807 808 809 810 811 812 813 814 815 816 817 818 819 820 821 822 823 824 825 826 827 828 829 830 831 832 833 834 835 836 837 838 839 840 841 842 843 844 845 846 847 848 849 850 851 852 
272 2560 512 3072 0 
68 3072 1024 4096 0 
4 4096 4096 8192 0 
17 4096 4096 6144 2048 
69 4096 4096 5120 3072 
70 5120 4096 6144 3072 
71 4096 3072 5120 2048 
285 4096 3072 4608 2560 
286 4608 3072 5120 2560 
287 4096 2560 4608 2048 470 471 472 473 474 483 484 485 486 487 503 504 505 506 507 508 509 510 511 512 513 514 515 516 517 554 565 566 567 568 569 616 617 618 619 620 664 
288 4608 2560 5120 2048 518 519 520 521 522 523 524 525 526 527 528 529 530 531 532 533 621 622 623 624 625 626 627 628 629 630 631 632 633 634 635 636 
72 5120 3072 6144 2048 
289 5120 3072 5632 2560 
290 5632 3072 6144 2560 
291 5120 2560 5632 2048 534 535 536 537 538 539 540 541 542 543 544 545 546 547 548 549 637 638 639 640 641 642 643 644 645 646 647 648 649 650 651 652 663 
292 5632 2560 6144 2048 550 551 552 553 555 556 570 571 572 573 574 575 576 577 578 579 580 581 600 601 602 603 604 605 610 611 612 613 614 615 653 654 
18 6144 4096 8192 2048 
73 6144 4096 7168 3072 
74 7168 4096 8192 3072 
75 6144 3072 7168 2048 
301 6144 3072 6656 2560 
302 6656 3072 7168 2560 
303 6144 2560 6656 2048 582 583 584 585 586 587 588 589 590 591 592 593 594 595 596 597 598 599 606 607 608 609 655 
304 6656 2560 7168 2048 
76 7168 3072 8192 2048 
19 4096 2048 6144 0 
20 6144 2048 8192 0 
<End>