0 0 4096 4096 0 
1 0 4096 2048 2048 
2 2048 4096 4096 2048 
3 0 2048 2048 0 
13 0 2048 1024 1024 
14 1024 2048 2048 1024 
15 0 1024 1024 0 
61 0 1024 512 512 67 68 69 70 71 72 129 133 134 135 136 137 138 195 195 196 197 67 68 69 70 71 72 129 133 134 135 136 137 138 195 196 197 67 68 69 70 71 72 129 133 134 135 136 137 138 195 196 197 67 68 69 70 71 72 129 133 134 135 136 137 138 195 196 197 
62 512 1024 1024 512 73 74 75 76 77 78 79 80 139 140 141 142 143 144 145 146 73 74 75 76 77 78 79 80 139 140 141 142 143 144 145 146 73 74 75 76 77 78 79 80 139 140 141 142 143 144 145 146 73 74 75 76 77 78 79 80 139 140 141 142 143 144 145 146 
63 0 512 512 0 130 131 132 198 199 200 201 202 203 204 205 130 131 132 198 199 200 201 202 203 204 205 130 131 132 198 199 200 201 202 203 204 205 130 131 132 198 199 200 201 202 203 204 205 
64 512 512 1024 0 1 26 27 28 29 30 31 32 206 207 208 209 210 211 213 214 1 26 27 28 29 30 31 32 206 207 208 209 210 211 213 214 1 26 27 28 29 30 31 32 206 207 208 209 210 211 213 1 26 27 28 29 30 31 32 206 207 208 209 210 211 213 
16 1024 1024 2048 0 
65 1024 1024 1536 512 81 82 83 84 85 86 87 88 147 148 149 150 151 152 153 154 81 82 83 84 85 86 87 88 147 148 149 150 151 152 153 154 81 82 83 84 85 86 87 88 147 148 149 150 151 152 153 154 81 82 83 84 85 86 87 88 147 148 149 150 151 152 153 154 
66 1536 1024 2048 512 89 90 91 92 93 94 95 96 155 156 157 158 159 160 161 162 89 90 91 92 93 94 95 96 155 156 157 158 159 160 161 162 89 90 91 92 93 94 95 96 155 156 157 158 159 160 161 162 89 90 91 92 93 94 95 96 155 156 157 158 159 160 161 162 
67 1024 512 1536 0 2 3 4 5 33 34 35 36 37 38 39 40 2 3 4 5 33 34 35 36 37 38 39 40 2 3 4 5 33 34 35 36 37 38 39 40 2 3 4 5 33 34 35 36 37 38 39 40 
68 1536 512 2048 0 6 7 8 9 41 42 43 44 45 46 47 48 6 7 8 9 41 42 43 44 45 46 47 48 6 7 8 9 41 42 43 44 45 46 47 48 6 7 8 9 41 42 43 44 45 46 47 48 
4 2048 2048 4096 0 
17 2048 2048 3072 1024 
18 3072 2048 4096 1024 
19 2048 1024 3072 0 
77 2048 1024 2560 512 97 98 99 100 101 102 103 104 163 164 165 166 167 168 169 170 97 98 99 100 101 102 103 104 163 164 165 166 167 168 169 170 97 98 99 100 101 102 103 104 163 164 165 166 167 168 169 170 97 98 99 100 101 102 103 104 163 164 165 166 167 168 169 170 
78 2560 1024 3072 512 105 106 107 108 109 110 111 112 171 172 173 174 175 176 177 178 105 106 107 108 109 110 111 112 171 172 173 174 175 176 177 178 105 106 107 108 109 110 111 112 171 172 173 174 175 176 177 178 105 106 107 108 109 110 111 112 171 172 173 174 175 176 177 178 
79 2048 512 2560 0 10 11 12 13 49 50 51 52 53 54 55 56 10 11 12 13 49 50 51 52 53 54 55 56 10 11 12 13 49 50 51 52 53 54 55 56 10 11 12 13 49 50 51 52 53 54 55 56 
80 2560 512 3072 0 14 15 16 17 57 58 59 60 61 62 63 64 14 15 16 17 57 58 59 60 61 62 63 64 14 15 16 17 57 58 59 60 61 62 63 64 14 15 16 17 57 58 59 60 61 62 63 64 
20 3072 1024 4096 0 
81 3072 1024 3584 512 113 114 115 116 117 118 119 120 179 180 181 182 183 184 185 186 113 114 115 116 117 118 119 120 179 180 181 182 183 184 185 186 113 114 115 116 117 118 119 120 179 180 181 182 183 184 185 186 113 114 115 116 117 118 119 120 179 180 181 182 183 184 185 186 
82 3584 1024 4096 512 121 122 123 124 125 126 127 128 187 188 189 190 191 192 193 194 121 122 123 124 125 126 127 128 187 188 189 190 191 192 193 194 121 122 123 124 125 126 127 128 187 188 189 190 191 192 193 194 121 122 123 124 125 126 127 128 187 188 189 190 191 192 193 194 
83 3072 512 3584 0 18 19 20 21 65 66 18 19 20 21 65 66 18 19 20 21 65 66 18 19 20 21 65 66 
84 3584 512 4096 0 22 23 24 25 212 22 23 24 25 212 22 23 24 25 212 22 23 24 25 212 
<End>