0 0 8192 8192 0 
1 0 8192 4096 4096 
5 0 8192 2048 6144 
6 2048 8192 4096 6144 
25 2048 8192 3072 7168 
101 2048 8192 2560 7680 1425 1426 1427 1428 1429 1430 1431 1432 1433 1434 1435 1436 1437 1438 1477 1478 1479 1480 1481 1482 1483 1484 1485 1486 1487 1488 1489 1490 
102 2560 8192 3072 7680 302 303 304 305 306 307 308 309 310 311 312 313 314 315 316 317 318 319 394 420 426 434 1562 1573 1574 1575 1578 1579 1582 1583 1586 1587 1590 1591 1594 1595 1596 1597 1598 1601 1610 1617 
103 2048 7680 2560 7168 1409 1410 1411 1412 1413 1414 1415 1416 1417 1418 1419 1420 1421 1422 1423 1424 1461 1462 1463 1464 1465 1466 1467 1468 1469 1470 1471 1472 1473 1474 1475 1476 
104 2560 7680 3072 7168 287 288 289 290 291 292 293 294 295 296 297 298 299 300 301 433 646 1216 1217 1218 1219 1220 1221 1222 1223 1224 1225 1342 1343 1346 1347 1350 1351 1354 1355 1358 1359 1362 1363 1366 1367 1370 1371 1374 1375 1378 1379 1521 1526 1527 1529 1530 1531 1532 1533 1534 1535 1536 1537 1538 1539 1540 1541 1542 1543 1544 1545 1546 1549 1550 1551 1552 1553 1554 1555 1558 1559 1563 1564 1565 1568 1569 1572 
26 3072 8192 4096 7168 
105 3072 8192 3584 7680 320 321 322 323 334 335 1576 1577 1580 1581 1584 1585 1588 1589 1592 1593 1599 1600 1602 1603 1604 1605 1606 1607 1608 1609 1611 1612 1613 1614 1615 1616 1618 1619 1620 1621 1622 1623 1624 1625 1626 1627 1628 1629 1630 1631 1632 1633 1634 1635 1636 1637 1638 1639 1640 1641 1646 1647 1648 1649 1675 1676 1677 1678 1679 1680 1681 1682 1683 1684 
106 3584 8192 4096 7680 336 337 338 339 340 341 342 343 344 345 346 347 348 349 350 351 352 353 354 355 356 357 358 359 360 361 421 422 436 437 648 1642 1643 1644 1645 1685 1686 1687 1688 1689 1690 1691 1692 1693 1694 1695 1696 1697 1698 1699 1700 1701 1702 1703 1704 1705 1706 1707 1708 1709 1710 1711 
107 3072 7680 3584 7168 1344 1345 1348 1349 1352 1353 1356 1357 1360 1361 1364 1365 1368 1369 1372 1373 1376 1377 1380 1381 1547 1548 1556 1557 1560 1561 1566 1567 1570 1571 1667 1668 1669 1670 1671 1672 1673 1674 1712 1713 1714 1715 1716 1717 1718 1719 
108 3584 7680 4096 7168 362 363 364 365 366 367 368 369 370 375 376 435 442 443 444 649 
27 2048 7168 3072 6144 
109 2048 7168 2560 6656 1393 1394 1395 1396 1397 1398 1399 1400 1401 1402 1403 1404 1405 1406 1407 1408 1445 1446 1447 1448 1449 1450 1451 1452 1453 1454 1455 1456 1457 1458 1459 1460 
110 2560 7168 3072 6656 265 266 267 268 269 270 271 272 273 274 275 276 277 278 279 280 281 282 283 284 285 286 1205 1206 1207 1208 1209 1210 1211 1212 1213 1214 1215 1278 1279 1282 1283 1286 1287 1290 1291 1294 1295 1298 1299 1302 1303 1306 1307 1310 1311 1314 1315 1318 1319 1322 1323 1326 1327 1330 1331 1334 1335 1338 1339 1519 1520 1522 1523 1524 1525 1754 1755 1756 1769 1770 1771 1772 1773 
111 2048 6656 2560 6144 226 227 228 229 230 231 232 233 234 235 644 652 1151 1152 1153 1154 1155 1158 1391 1392 1443 1444 1491 1501 1507 1513 
112 2560 6656 3072 6144 246 247 248 249 250 251 252 253 254 255 256 257 258 259 260 261 262 263 264 419 429 645 1190 1191 1192 1193 1194 1195 1196 1199 1200 1201 1202 1203 1204 1226 1227 1230 1231 1234 1235 1238 1239 1242 1243 1246 1247 1250 1251 1254 1255 1258 1259 1262 1263 1266 1267 1270 1271 1274 1275 1382 1383 1386 1387 1388 1389 1390 1439 1440 1492 1493 1494 1495 1496 1497 1498 1499 1500 1502 1503 1504 1505 1506 1508 1509 1510 1511 1512 1514 1515 1516 1517 1518 1749 1750 1751 1752 1753 1766 1767 1768 
28 3072 7168 4096 6144 
113 3072 7168 3584 6656 1280 1281 1284 1285 1288 1289 1292 1293 1296 1297 1300 1301 1304 1305 1308 1309 1312 1313 1316 1317 1320 1321 1324 1325 1328 1329 1332 1333 1336 1337 1340 1341 1659 1660 1661 1662 1663 1664 1665 1666 1720 1721 1722 1723 1724 1725 1726 1727 1728 
114 3584 7168 4096 6656 371 372 373 374 377 378 379 380 381 382 383 384 385 386 387 388 389 445 446 447 448 
115 3072 6656 3584 6144 1197 1198 1228 1229 1232 1233 1236 1237 1240 1241 1244 1245 1248 1249 1252 1253 1256 1257 1260 1261 1264 1265 1268 1269 1272 1273 1276 1277 1384 1385 1441 1442 1650 1651 1652 1653 1654 1655 1656 1657 1658 1729 1730 1731 1732 1733 
116 3584 6656 4096 6144 449 450 451 452 453 454 455 456 462 463 464 465 466 467 468 469 475 476 477 478 479 480 481 482 483 484 485 486 487 488 489 544 545 546 547 548 549 550 551 
7 0 6144 2048 4096 
29 0 6144 1024 5120 
30 1024 6144 2048 5120 
121 1024 6144 1536 5632 
122 1536 6144 2048 5632 199 200 201 202 203 204 205 206 207 208 209 210 211 212 213 214 215 216 217 218 219 220 221 418 427 428 432 643 700 703 704 705 706 707 708 1051 1058 1065 1066 1067 1068 1069 1076 1083 1090 1097 1104 1105 1106 1107 1113 1114 1120 1121 1122 1128 1129 1130 1131 1132 1133 1134 1139 1140 1757 1758 
123 1024 5632 1536 5120 
124 1536 5632 2048 5120 185 186 188 189 190 191 192 193 194 195 196 197 198 390 392 393 416 417 424 425 431 654 684 685 686 687 688 689 690 691 692 693 694 695 696 697 698 699 709 710 715 716 717 721 1742 1745 1746 1747 1748 
31 0 5120 1024 4096 
125 0 5120 512 4608 
126 512 5120 1024 4608 
127 0 4608 512 4096 1 2 3 4 5 6 7 8 29 30 31 32 33 34 35 36 57 58 59 60 61 62 63 64 65 66 67 68 69 70 71 72 93 94 95 96 97 98 99 100 101 102 108 399 400 403 404 406 407 1737 
128 512 4608 1024 4096 9 10 11 12 13 14 15 16 37 38 39 40 41 42 43 44 73 74 75 76 77 78 79 80 81 82 83 84 85 86 87 88 103 104 105 106 107 109 110 121 122 401 402 405 408 409 410 411 412 430 653 
32 1024 5120 2048 4096 
129 1024 5120 1536 4608 
130 1536 5120 2048 4608 164 165 166 167 168 169 170 171 172 173 174 175 176 177 178 179 180 181 182 183 184 187 391 415 423 673 674 675 676 677 678 679 680 681 682 683 701 702 711 712 713 714 718 719 720 862 869 870 871 872 879 880 881 882 889 890 891 898 899 900 1738 1739 1741 1743 1744 1763 1764 1765 
131 1024 4608 1536 4096 17 18 19 20 21 22 23 45 46 47 48 49 50 51 89 90 91 92 123 124 125 126 127 128 131 132 133 134 135 136 137 138 139 140 141 142 143 395 396 397 398 438 439 440 
132 1536 4608 2048 4096 24 25 26 27 28 52 53 54 55 56 111 112 113 114 115 116 117 118 119 120 129 130 144 145 146 147 148 149 150 151 152 153 154 155 156 157 158 159 160 161 162 163 413 414 441 655 656 657 658 659 660 661 662 663 664 665 666 667 668 669 670 671 672 728 732 736 740 741 745 746 750 751 755 756 760 761 762 1736 1740 1759 1760 1761 1762 
8 2048 6144 4096 4096 
33 2048 6144 3072 5120 
133 2048 6144 2560 5632 222 223 224 225 1039 1040 1041 1042 1043 1044 1045 1046 1047 1048 1049 1050 1052 1053 1054 1055 1056 1057 1059 1060 1061 1062 1063 1064 1070 1071 1072 1073 1074 1075 1077 1078 1079 1080 1081 1082 1084 1085 1086 1087 1088 1089 1091 1092 1093 1094 1095 1096 1098 1099 1100 1101 1102 1103 1108 1109 1110 1111 1112 1115 1116 1117 1118 1119 1123 1124 1125 1126 1127 1135 1136 1137 1138 1141 1142 1143 1144 1145 1146 1147 1148 1149 1150 1156 1157 1159 1160 1161 1162 1163 1164 1165 1171 1172 1173 1174 1734 1735 
134 2560 6144 3072 5632 236 237 238 239 240 241 242 243 244 245 1166 1167 1168 1169 1170 1175 1176 1177 1178 1179 1180 1181 1182 1185 1186 1187 
135 2048 5632 2560 5120 943 944 945 946 947 948 949 950 951 952 953 954 955 956 957 958 959 960 961 962 963 964 965 966 967 968 969 970 971 972 973 974 975 976 977 978 979 980 981 982 983 984 985 986 987 988 989 990 991 992 993 994 995 996 997 998 999 1000 1001 1002 1003 1004 1005 1006 1007 1008 1009 1010 1011 1012 1013 1014 1015 1016 1017 1018 1019 1020 1021 1022 1023 1024 1025 1026 1027 1028 1029 1030 1031 1032 1033 1034 1035 1036 1037 1038 
136 2560 5632 3072 5120 
34 3072 6144 4096 5120 
137 3072 6144 3584 5632 1183 1184 1188 1189 
138 3584 6144 4096 5632 
139 3072 5632 3584 5120 
140 3584 5632 4096 5120 
35 2048 5120 3072 4096 
141 2048 5120 2560 4608 832 833 834 835 836 837 838 839 840 841 842 843 844 845 846 847 848 849 850 851 852 853 854 855 856 857 858 859 860 861 863 864 865 866 867 868 873 874 875 876 877 878 883 884 885 886 887 888 892 893 894 895 896 897 901 902 903 904 905 906 907 908 909 910 911 912 913 914 915 916 917 918 919 920 921 922 923 924 925 926 927 928 929 930 931 932 933 934 935 936 937 938 939 940 941 942 
142 2560 5120 3072 4608 
143 2048 4608 2560 4096 722 723 724 725 726 727 729 730 731 733 734 735 737 738 739 742 743 744 747 748 749 752 753 754 757 758 759 763 764 765 766 767 768 769 770 771 772 773 774 775 776 777 778 779 780 781 782 783 784 785 786 787 788 789 790 791 792 793 794 795 796 797 798 799 800 801 802 803 804 805 806 807 808 809 810 811 812 813 814 815 816 817 818 819 820 821 822 823 824 825 826 827 828 829 830 831 
144 2560 4608 3072 4096 
36 3072 5120 4096 4096 
2 4096 8192 8192 4096 
9 4096 8192 6144 6144 
37 4096 8192 5120 7168 
38 5120 8192 6144 7168 
39 4096 7168 5120 6144 
157 4096 7168 4608 6656 
158 4608 7168 5120 6656 
159 4096 6656 4608 6144 457 458 459 460 461 470 471 472 473 474 490 491 492 493 494 495 496 497 498 499 500 501 502 503 504 541 552 553 554 555 556 603 604 605 606 607 651 
160 4608 6656 5120 6144 505 506 507 508 509 510 511 512 513 514 515 516 517 518 519 520 608 609 610 611 612 613 614 615 616 617 618 619 620 621 622 623 
40 5120 7168 6144 6144 
161 5120 7168 5632 6656 
162 5632 7168 6144 6656 
163 5120 6656 5632 6144 521 522 523 524 525 526 527 528 529 530 531 532 533 534 535 536 624 625 626 627 628 629 630 631 632 633 634 635 636 637 638 639 650 
164 5632 6656 6144 6144 537 538 539 540 542 543 557 558 559 560 561 562 563 564 565 566 567 568 587 588 589 590 591 592 597 598 599 600 601 602 640 641 
10 6144 8192 8192 6144 
41 6144 8192 7168 7168 
42 7168 8192 8192 7168 
43 6144 7168 7168 6144 
173 6144 7168 6656 6656 
174 6656 7168 7168 6656 
175 6144 6656 6656 6144 569 570 571 572 573 574 575 576 577 578 579 580 581 582 583 584 585 586 593 594 595 596 642 
176 6656 6656 7168 6144 
44 7168 7168 8192 6144 
11 4096 6144 6144 4096 
12 6144 6144 8192 4096 
3 0 4096 4096 0 
13 0 4096 2048 2048 
14 2048 4096 4096 2048 
15 0 2048 2048 0 
61 0 2048 1024 1024 
62 1024 2048 2048 1024 
249 1024 2048 1536 1536 
250 1536 2048 2048 1536 1774 
251 1024 1536 1536 1024 
252 1536 1536 2048 1024 
63 0 1024 1024 0 
64 1024 1024 2048 0 
16 2048 2048 4096 0 
4 4096 4096 8192 0 
<End>