0 0 4096 4096 0 
1 0 4096 2048 2048 
2 2048 4096 4096 2048 
3 0 2048 2048 0 
13 0 2048 1024 1024 
14 1024 2048 2048 1024 
15 0 1024 1024 0 
61 0 1024 512 512 
62 512 1024 1024 512 
63 0 512 512 0 1 2 3 4 5 6 7 8 65 66 67 68 69 70 71 72 138 65 66 67 68 69 70 71 72 138 1 2 3 4 5 6 7 8 
64 512 512 1024 0 9 10 11 12 13 14 15 16 73 74 75 76 77 78 79 80 129 134 135 136 137 73 74 75 76 77 78 79 80 129 134 135 136 137 9 10 11 12 13 14 15 17 
16 1024 1024 2048 0 
65 1024 1024 1536 512 
66 1536 1024 2048 512 
67 1024 512 1536 0 17 18 19 20 21 22 23 24 81 82 83 84 85 86 87 88 81 82 83 84 85 86 87 88 16 18 20 19 21 22 23 25 
68 1536 512 2048 0 25 26 27 28 29 30 31 32 89 90 91 92 93 94 95 96 130 89 90 91 92 93 94 95 96 130 26 24 27 29 28 30 31 33 
4 2048 2048 4096 0 
17 2048 2048 3072 1024 
18 3072 2048 4096 1024 
19 2048 1024 3072 0 
77 2048 1024 2560 512 
78 2560 1024 3072 512 
79 2048 512 2560 0 33 34 35 36 37 38 39 40 97 98 99 100 101 102 103 104 131 97 98 99 100 101 102 103 104 131 34 32 35 36 37 38 39 40 
80 2560 512 3072 0 41 42 43 44 45 46 47 48 105 106 107 108 109 110 111 112 133 105 106 107 108 109 110 111 112 133 41 42 43 44 45 46 47 48 
20 3072 1024 4096 0 
81 3072 1024 3584 512 
82 3584 1024 4096 512 
83 3072 512 3584 0 49 50 51 52 53 54 55 56 113 114 115 116 117 118 119 120 113 114 115 116 117 118 119 120 49 50 51 52 53 54 55 56 
84 3584 512 4096 0 57 58 59 60 61 62 63 64 121 122 123 124 125 126 127 128 132 121 122 123 124 125 126 127 128 132 57 58 64 63 62 60 59 61 
<End>