0 0 4096 4096 0 
1 0 4096 2048 2048 
2 2048 4096 4096 2048 
3 0 2048 2048 0 
13 0 2048 1024 1024 
14 1024 2048 2048 1024 
15 0 1024 1024 0 
61 0 1024 512 512 273 274 275 276 277 278 290 291 292 293 294 295 307 308 309 310 311 312 
62 512 1024 1024 512 279 280 281 282 283 284 285 286 296 297 298 299 300 301 302 303 313 314 315 316 317 318 319 320 
63 0 512 512 0 1 2 3 4 5 6 7 8 60 61 62 63 64 65 66 67 119 120 121 122 123 124 125 126 178 179 180 181 182 239 240 241 242 243 244 256 257 258 259 260 261 
64 512 512 1024 0 9 10 11 12 13 14 15 16 68 69 70 71 72 73 74 75 127 128 129 130 131 132 133 134 183 184 185 220 237 245 246 247 248 249 250 251 252 262 263 264 265 266 267 268 269 
16 1024 1024 2048 0 
65 1024 1024 1536 512 287 288 289 304 305 306 321 322 323 331 332 333 334 335 338 339 340 341 342 345 346 347 348 349 
66 1536 1024 2048 512 192 193 194 195 222 227 228 235 336 337 343 344 350 351 360 361 362 363 447 
67 1024 512 1536 0 17 18 19 20 21 22 76 77 78 79 80 81 135 136 137 138 139 140 186 187 188 189 221 253 254 255 270 271 272 324 325 326 327 328 352 353 354 355 356 434 
68 1536 512 2048 0 23 24 25 26 27 28 29 82 83 84 85 86 87 88 141 142 143 144 145 146 147 190 191 223 238 329 330 357 358 359 
4 2048 2048 4096 0 
17 2048 2048 3072 1024 
18 3072 2048 4096 1024 
19 2048 1024 3072 0 
77 2048 1024 2560 512 196 197 198 199 200 225 229 230 231 232 233 234 435 436 448 
78 2560 1024 3072 512 
79 2048 512 2560 0 30 31 32 33 34 35 36 37 89 90 91 92 93 94 95 96 148 149 150 151 152 153 154 155 201 224 
80 2560 512 3072 0 38 39 40 41 42 43 44 45 97 98 99 100 101 102 103 104 156 157 158 159 160 161 162 163 202 203 204 205 226 236 364 365 366 367 433 
20 3072 1024 4096 0 
81 3072 1024 3584 512 390 391 392 393 394 401 402 403 404 405 412 413 414 415 416 444 445 446 
82 3584 1024 4096 512 395 396 397 398 399 400 406 407 408 409 410 411 417 418 419 420 421 422 426 427 428 429 430 432 
83 3072 512 3584 0 46 47 48 49 50 51 105 106 107 108 109 110 164 165 166 167 168 169 206 207 208 209 210 211 212 215 216 217 218 368 369 370 371 372 379 380 381 382 383 437 438 439 440 441 442 443 449 
84 3584 512 4096 0 52 53 54 55 56 57 58 59 111 112 113 114 115 116 117 118 170 171 172 173 174 175 176 177 219 373 374 375 376 377 378 384 385 386 387 388 389 423 424 
<End>