0 0 8192 8192 0 
1 0 8192 4096 4096 
5 0 8192 2048 6144 
6 2048 8192 4096 6144 
7 0 6144 2048 4096 
8 2048 6144 4096 4096 
33 2048 6144 3072 5120 
34 3072 6144 4096 5120 
35 2048 5120 3072 4096 
141 2048 5120 2560 4608 
142 2560 5120 3072 4608 
143 2048 4608 2560 4096 686 687 688 689 686 687 688 689 686 687 688 689 
144 2560 4608 3072 4096 
36 3072 5120 4096 4096 
145 3072 5120 3584 4608 
146 3584 5120 4096 4608 
147 3072 4608 3584 4096 382 383 384 385 386 387 388 389 390 391 742 382 383 384 385 386 387 388 389 390 391 742 382 383 384 385 386 387 388 389 390 391 742 
148 3584 4608 4096 4096 
2 4096 8192 8192 4096 
3 0 4096 4096 0 
13 0 4096 2048 2048 
14 2048 4096 4096 2048 
57 2048 4096 3072 3072 
229 2048 4096 2560 3584 675 676 677 678 679 680 683 684 685 1104 1105 1106 1107 1108 1109 1110 1111 1112 1113 1114 1115 1116 1117 675 676 677 678 679 680 683 684 685 1104 1105 1106 1107 1108 1109 1110 1111 1112 1113 1114 1115 1116 1117 675 676 677 678 679 680 683 684 685 1104 1105 1106 1107 1108 1109 1110 1111 1112 1113 1114 1115 1116 1117 
230 2560 4096 3072 3584 359 360 361 362 363 364 365 366 367 368 369 370 371 372 373 374 375 376 377 666 667 668 669 670 671 672 673 674 695 707 708 709 710 711 712 713 714 715 716 717 718 719 720 721 722 723 724 725 983 1096 1097 1098 1099 1100 1101 1102 1103 1175 1186 359 360 361 362 363 364 365 366 367 368 369 370 371 372 373 374 375 376 377 666 667 668 669 670 671 672 673 674 695 707 708 709 710 711 712 713 714 715 716 717 718 719 720 721 722 723 724 725 983 1096 1097 1098 1099 1100 1101 1102 1103 1175 1186 359 360 361 362 363 364 365 366 367 368 369 370 371 372 373 374 375 376 377 666 667 668 669 670 671 672 673 674 695 707 708 709 710 711 712 713 714 715 716 717 718 719 720 721 722 723 724 725 983 1096 1097 1098 1099 1100 1101 1102 1103 1175 1186 
231 2048 3584 2560 3072 638 645 646 647 648 649 650 651 652 653 676 681 682 1088 1089 1090 1091 1092 1093 638 645 646 647 648 649 650 651 652 653 681 682 1088 1089 1090 1091 1092 1093 1220 1221 638 645 646 647 648 649 650 651 652 653 681 682 1088 1089 1090 1091 1092 1093 1220 1221 
232 2560 3584 3072 3072 344 345 346 347 348 349 350 351 352 353 354 355 356 357 358 654 655 656 657 658 659 660 661 662 663 664 665 690 691 692 693 694 696 697 698 699 700 701 702 703 704 705 706 1072 1073 1074 1075 1084 1085 1086 1087 1094 1095 1185 344 345 346 347 348 349 350 351 352 353 354 355 356 357 358 654 655 656 657 658 659 660 661 662 663 664 665 690 691 692 693 694 696 697 698 699 700 701 702 703 704 705 706 1072 1073 1074 1075 1084 1085 1086 1087 1094 1095 1185 344 345 346 347 348 349 350 351 352 353 354 355 356 357 358 654 655 656 657 658 659 660 661 662 663 664 665 690 691 692 693 694 696 697 698 699 700 701 702 703 704 705 706 1072 1073 1074 1075 1084 1085 1086 1087 1094 1095 1185 
58 3072 4096 4096 3072 
233 3072 4096 3584 3584 378 379 380 381 392 393 726 727 728 729 730 731 732 733 734 735 736 737 738 739 740 741 743 744 745 746 747 748 749 750 751 752 753 754 755 756 757 758 759 760 761 767 768 769 770 771 772 773 774 775 776 777 778 779 780 781 782 783 784 785 786 787 795 796 801 802 803 804 948 949 950 951 1118 1119 378 379 380 381 392 393 726 727 728 729 730 731 732 733 734 735 736 737 738 739 740 741 743 744 745 746 747 748 749 750 751 752 753 754 755 756 757 758 759 760 761 767 768 769 770 771 772 773 774 775 776 777 778 779 780 781 782 783 784 785 786 787 795 796 801 802 803 804 948 949 950 951 1118 1119 378 379 380 381 392 393 726 727 728 729 730 731 732 733 734 735 736 737 738 739 740 741 743 744 745 746 747 748 749 750 751 752 753 754 755 756 757 758 759 760 761 767 768 769 770 771 772 773 774 775 776 777 778 779 780 781 782 783 784 785 786 787 795 796 801 802 803 804 948 949 950 951 1118 1119 
234 3584 4096 4096 3584 394 395 396 397 398 399 400 405 401 402 403 404 405 406 407 408 409 410 411 412 413 414 415 416 417 418 419 762 763 764 765 766 788 789 790 791 792 793 794 797 805 806 807 984 1120 1121 1122 1123 1124 1125 1126 1152 1153 1127 1128 1129 1130 1131 1132 1133 1134 1135 1144 1145 1188 1189 394 395 396 397 398 399 400 401 402 403 404 405 406 407 408 409 410 411 412 413 414 415 416 417 418 419 762 763 764 765 766 788 789 790 791 792 793 794 797 805 806 807 984 1120 1121 1122 1123 1124 1125 1126 1127 1128 1129 1130 1131 1132 1133 1134 1135 1144 1145 1188 1189 394 395 396 397 398 399 400 401 402 403 404 405 406 407 408 409 410 411 412 413 414 415 416 417 418 419 762 763 764 765 766 788 789 790 791 792 793 794 797 805 806 807 984 1120 1121 1122 1123 1124 1125 1126 1127 1128 1129 1130 1131 1132 1133 1134 1135 1144 1145 1188 1189 
235 3072 3584 3584 3072 798 799 800 808 809 810 811 812 816 817 818 819 820 1136 1137 1138 1140 798 799 800 808 809 810 811 812 816 817 818 819 820 1136 1137 1138 1140 798 799 800 808 809 810 811 812 816 817 818 819 820 1136 1137 1138 1140 
236 3584 3584 4096 3072 420 421 422 423 424 425 426 427 428 429 430 435 436 933 934 935 936 937 938 939 940 941 942 943 944 945 946 947 1139 1141 1142 1143 1151 1152 1153 1154 1155 1156 1157 1204 1187 420 421 422 423 424 425 426 427 428 429 430 435 436 933 934 935 936 937 938 939 940 941 942 943 944 945 946 947 1139 1141 1142 1143 1151 1152 1153 1154 1155 1156 1157 1187 1191 420 421 422 423 424 425 426 427 428 429 430 435 436 933 934 935 936 937 938 939 940 941 942 943 944 945 946 947 1139 1141 1142 1143 1151 1152 1153 1154 1155 1156 1157 1187 1191 
59 2048 3072 3072 2048 
237 2048 3072 2560 2560 626 637 639 640 641 642 643 644 1051 1054 1055 1057 1058 1059 1060 1061 1062 1063 1064 1065 1066 1067 1068 1069 1070 1071 626 637 639 640 641 642 643 644 1051 1054 1055 1057 1058 1059 1060 1061 1062 1063 1064 1065 1066 1067 1068 1069 1070 1071 626 637 639 640 641 642 643 644 1051 1054 1055 1057 1058 1059 1060 1061 1062 1063 1064 1065 1066 1067 1068 1069 1070 1071 
238 2560 3072 3072 2560 320 321 322 323 324 325 326 327 328 329 330 331 332 333 334 335 336 337 338 339 340 341 342 343 614 615 616 618 619 620 621 622 623 624 625 647 627 628 629 630 631 632 633 634 635 636 981 982 1076 1077 1078 1079 1080 1081 1082 1083 1184 320 321 322 323 324 325 326 327 328 329 330 331 332 333 334 335 336 337 338 339 340 341 342 343 614 615 616 618 619 620 621 622 623 624 625 627 628 629 630 631 632 633 634 635 636 981 982 1076 1077 1078 1079 1080 1081 1082 1083 1184 1218 1219 320 321 322 323 324 325 326 327 328 329 330 331 332 333 334 335 336 337 338 339 340 341 342 343 614 615 616 618 619 620 621 622 623 624 625 627 628 629 630 631 632 633 634 635 636 981 982 1076 1077 1078 1079 1080 1081 1082 1083 1184 1218 1219 
239 2048 2560 2560 2048 278 279 280 281 282 283 284 285 286 287 553 554 555 556 561 613 625 626 627 628 1052 1053 1056 278 279 280 281 282 283 284 285 286 287 553 554 555 556 561 613 1052 1053 1056 1211 1212 1213 278 279 280 281 282 283 284 285 286 287 553 554 555 556 561 613 1052 1053 1056 1211 1212 1213 
240 2560 2560 3072 2048 300 301 302 303 304 305 306 307 308 309 310 311 312 313 314 315 316 317 318 319 591 592 601 602 603 604 605 606 612 607 608 609 610 611 612 620 621 622 623 624 629 630 631 632 633 617 638 980 1041 1042 1043 1044 1045 1046 1047 1048 1049 1050 1178 1179 300 301 302 303 304 305 306 307 308 309 310 311 312 313 314 315 316 317 318 319 591 592 601 602 603 604 605 606 607 608 609 610 611 612 617 980 1041 1042 1043 1044 1045 1046 1047 1048 1049 1050 1178 1179 1201 1202 1203 1204 1205 1206 1207 1208 1209 1210 1214 1215 1216 1217 300 301 302 303 304 305 306 307 308 309 310 311 312 313 314 315 316 317 318 319 591 592 601 602 603 604 605 606 607 608 609 610 611 612 617 980 1041 1042 1043 1044 1045 1046 1047 1048 1049 1050 1178 1179 1201 1202 1203 1204 1205 1206 1207 1208 1209 1210 1214 1215 1216 1217 
60 3072 3072 4096 2048 
241 3072 3072 3584 2560 813 814 815 821 822 823 824 825 826 827 828 1146 1148 1150 1158 1160 1162 1163 813 814 815 821 822 823 824 825 826 827 828 1146 1148 1150 1158 1160 1162 1163 813 814 815 821 822 823 824 825 826 827 828 1146 1148 1150 1158 1160 1162 1163 
242 3584 3072 4096 2560 431 432 433 434 437 438 439 440 441 442 443 444 445 446 447 448 449 450 451 1147 1149 1159 1161 1190 431 432 433 434 437 438 439 440 441 442 443 444 445 446 447 448 449 450 451 1147 1149 1159 1161 1190 431 432 433 434 437 438 439 440 441 442 443 444 445 446 447 448 449 450 451 1147 1149 1159 1161 1190 
243 3072 2560 3584 2048 830 832 836 857 858 1202 830 832 836 857 858 830 832 836 857 858 
244 3584 2560 4096 2048 452 453 454 455 456 457 458 459 460 461 462 829 831 833 834 835 859 860 861 862 863 864 865 866 867 868 869 870 871 872 878 879 452 453 454 455 456 457 458 459 460 461 462 829 831 833 834 835 859 860 861 862 863 864 865 866 867 868 869 870 871 872 878 879 452 453 454 455 456 457 458 459 460 461 462 829 831 833 834 835 859 860 861 862 863 864 865 866 867 868 869 870 871 872 878 879 
15 0 2048 2048 0 
61 0 2048 1024 1024 
62 1024 2048 2048 1024 
249 1024 2048 1536 1536 
250 1536 2048 2048 1536 199 200 201 202 203 204 205 206 207 208 209 210 211 250 251 252 253 254 255 256 257 258 259 260 261 262 263 264 265 266 267 268 269 271 272 273 538 539 540 541 542 543 544 545 546 547 548 549 550 979 1019 1020 1021 1025 1026 1027 1028 1029 1030 1031 1032 1033 1034 1035 1036 1037 1038 1039 1040 1176 1177 1183 199 200 201 202 203 204 205 206 207 208 209 210 211 250 251 252 253 254 255 256 257 258 259 260 261 262 263 264 265 266 267 268 269 271 272 273 538 539 540 541 542 543 544 545 546 547 548 549 550 979 1019 1020 1021 1025 1026 1027 1028 1029 1030 1031 1032 1033 1034 1035 1036 1037 1038 1039 1040 1176 1177 1183 199 200 201 202 203 204 205 206 207 208 209 210 211 250 251 252 253 254 255 256 257 258 259 260 261 262 263 264 265 266 267 268 269 271 272 273 538 539 540 541 542 543 544 545 546 547 548 549 550 979 1019 1020 1021 1025 1026 1027 1028 1029 1030 1031 1032 1033 1034 1035 1036 1037 1038 1039 1040 1176 1177 1183 
251 1024 1536 1536 1024 
252 1536 1536 2048 1024 191 192 193 194 198 195 196 197 198 235 236 238 239 240 241 242 243 244 245 246 247 248 249 270 526 530 531 532 533 534 535 536 537 976 977 978 1009 1011 1013 1015 1017 1023 1173 1174 1182 191 192 193 194 195 196 197 198 235 236 238 239 240 241 242 243 244 245 246 247 248 249 270 526 530 531 532 533 534 535 536 537 976 977 978 1009 1011 1013 1015 1017 1023 1173 1174 1182 1197 191 192 193 194 195 196 197 198 235 236 238 239 240 241 242 243 244 245 246 247 248 249 270 526 530 531 532 533 534 535 536 537 976 977 978 1009 1011 1013 1015 1017 1023 1173 1174 1182 1197 
63 0 1024 1024 0 
253 0 1024 512 512 
254 512 1024 1024 512 
255 0 512 512 0 1 2 3 4 5 6 7 8 29 30 31 32 33 34 35 36 57 58 59 60 61 62 63 64 65 66 67 68 69 70 71 72 93 94 95 96 97 98 99 100 101 102 108 109 956 957 960 961 963 964 1 2 3 4 5 6 7 8 29 30 31 32 33 34 35 36 57 58 59 60 61 62 63 64 65 66 67 68 69 70 71 72 93 94 95 96 97 98 99 100 101 102 108 109 956 957 960 961 963 964 1 2 3 4 5 6 7 8 29 30 31 32 33 34 35 36 57 58 59 60 61 62 63 64 65 66 67 68 69 70 71 72 93 94 95 96 97 98 99 100 101 102 108 109 956 957 960 961 963 964 
256 512 512 1024 0 9 10 11 12 13 14 15 16 37 38 39 40 41 42 43 44 73 74 75 76 77 78 79 80 81 82 83 84 85 86 87 88 103 104 105 106 107 110 111 122 123 958 959 962 965 966 967 968 969 1180 9 10 11 12 13 14 15 16 37 38 39 40 41 42 43 44 73 74 75 76 77 78 79 80 81 82 83 84 85 86 87 88 103 104 105 106 107 110 111 122 123 958 959 962 965 966 967 968 969 1180 9 10 11 12 13 14 15 16 37 38 39 40 41 42 43 44 73 74 75 76 77 78 79 80 81 82 83 84 85 86 87 88 103 104 105 106 107 110 111 122 123 958 959 962 965 966 967 968 969 1180 
64 1024 1024 2048 0 
257 1024 1024 1536 512 
258 1536 1024 2048 512 181 182 183 184 185 186 189 187 188 189 190 212 213 214 215 216 217 218 219 220 221 222 223 224 225 226 227 228 229 230 231 232 233 234 237 512 513 514 515 516 517 518 519 520 521 522 523 524 525 527 528 529 973 974 975 994 995 996 997 998 1172 1181 181 182 183 184 185 186 187 188 189 190 212 213 214 215 216 217 218 219 220 221 222 223 224 225 226 227 228 229 230 231 232 233 234 237 512 513 514 515 516 517 518 519 520 521 522 523 524 525 527 528 529 973 974 975 994 995 996 997 998 1172 1181 1195 181 182 183 184 185 186 187 188 189 190 212 213 214 215 216 217 218 219 220 221 222 223 224 225 226 227 228 229 230 231 232 233 234 237 512 513 514 515 516 517 518 519 520 521 522 523 524 525 527 528 529 973 974 975 994 995 996 997 998 1172 1181 1195 
259 1024 512 1536 0 17 18 19 20 21 22 23 45 46 47 48 49 50 51 89 90 91 92 124 125 126 127 128 129 132 133 134 135 136 137 138 139 140 141 142 142 144 143 144 952 953 954 955 979 980 17 18 19 20 21 22 23 45 46 47 48 49 50 51 89 90 91 92 124 125 126 127 128 129 132 133 134 135 136 137 138 139 140 141 142 143 144 952 953 954 955 1192 1193 1194 17 18 19 20 21 22 23 45 46 47 48 49 50 51 89 90 91 92 124 125 126 127 128 129 132 133 134 135 136 137 138 139 140 141 142 143 144 952 953 954 955 1192 1193 1194 
260 1536 512 2048 0 24 25 26 27 28 52 53 54 55 56 112 113 114 115 116 117 118 119 120 121 130 131 145 146 147 148 149 150 151 152 153 154 155 156 157 158 159 160 161 162 163 164 165 166 167 168 169 170 171 172 173 174 175 176 177 178 179 180 507 508 509 510 511 970 971 972 985 986 987 988 989 990 991 992 993 24 25 26 27 28 52 53 54 55 56 112 113 114 115 116 117 118 119 120 121 130 131 145 146 147 148 149 150 151 152 153 154 155 156 157 158 159 160 161 162 163 164 165 166 167 168 169 170 171 172 173 174 175 176 177 178 179 180 507 508 509 510 511 970 971 972 985 986 987 988 989 990 991 992 993 24 25 26 27 28 52 53 54 55 56 112 113 114 115 116 117 118 119 120 121 130 131 145 146 147 148 149 150 151 152 153 154 155 156 157 158 159 160 161 162 163 164 165 166 167 168 169 170 171 172 173 174 175 176 177 178 179 180 507 508 509 510 511 970 971 972 985 986 987 988 989 990 991 992 993 
16 2048 2048 4096 0 
65 2048 2048 3072 1024 
261 2048 2048 2560 1536 274 275 276 277 288 289 551 552 557 558 559 560 562 563 564 565 566 567 568 569 570 571 572 573 574 575 576 1022 274 275 276 277 288 289 551 552 557 558 559 560 562 563 564 565 566 567 568 569 570 571 572 573 574 575 576 1022 1199 1200 274 275 276 277 288 289 551 552 557 558 559 560 562 563 564 565 566 567 568 569 570 571 572 573 574 575 576 1022 1199 1200 
262 2560 2048 3072 1536 290 291 292 293 294 295 296 297 298 299 577 578 579 580 581 582 583 584 585 586 587 588 589 590 593 594 595 596 597 598 599 600 290 291 292 293 294 295 296 297 298 299 577 578 579 580 581 582 583 584 585 586 587 588 589 590 593 594 595 596 597 598 599 600 290 291 292 293 294 295 296 297 298 299 577 578 579 580 581 582 583 584 585 586 587 588 589 590 593 594 595 596 597 598 599 600 
263 2048 1536 2560 1024 1010 1012 1014 1016 1018 1024 1010 1012 1014 1016 1018 1024 1198 1010 1012 1014 1016 1018 1024 1198 
264 2560 1536 3072 1024 
66 3072 2048 4096 1024 
67 2048 1024 3072 0 
269 2048 1024 2560 512 1004 1005 1006 1007 1008 1004 1005 1006 1007 1008 1196 1004 1005 1006 1007 1008 1196 
270 2560 1024 3072 512 
271 2048 512 2560 0 999 1000 1001 1002 1003 999 1000 1001 1002 1003 999 1000 1001 1002 1003 
272 2560 512 3072 0 
68 3072 1024 4096 0 
4 4096 4096 8192 0 
17 4096 4096 6144 2048 
69 4096 4096 5120 3072 
70 5120 4096 6144 3072 
71 4096 3072 5120 2048 
285 4096 3072 4608 2560 
286 4608 3072 5120 2560 493 494 495 496 497 498 499 500 501 502 503 504 505 506 885 886 887 888 889 919 920 921 493 494 495 496 497 498 499 500 501 502 503 504 505 506 885 886 887 888 889 919 920 921 493 494 495 496 497 498 499 500 501 502 503 504 505 506 885 886 887 888 889 919 920 921 
287 4096 2560 4608 2048 463 464 465 466 467 468 469 470 471 472 473 474 475 476 477 478 837 838 839 840 841 842 873 874 875 876 877 880 881 882 883 884 463 464 465 466 467 468 469 470 471 472 473 474 475 476 477 478 837 838 839 840 841 842 873 874 875 876 877 880 881 882 883 884 463 464 465 466 467 468 469 470 471 472 473 474 475 476 477 478 837 838 839 840 841 842 873 874 875 876 877 880 881 882 883 884 
288 4608 2560 5120 2048 479 480 481 482 483 484 485 486 487 488 489 490 491 492 843 844 845 846 847 848 849 850 851 852 853 854 855 856 890 891 892 893 479 480 481 482 483 484 485 486 487 488 489 490 491 492 843 844 845 846 847 848 849 850 851 852 853 854 855 856 890 891 892 893 479 480 481 482 483 484 485 486 487 488 489 490 491 492 843 844 845 846 847 848 849 850 851 852 853 854 855 856 890 891 892 893 
72 5120 3072 6144 2048 
289 5120 3072 5632 2560 913 914 915 916 917 918 922 923 924 925 926 927 928 929 930 931 1168 1169 1170 913 914 915 916 917 918 922 923 924 925 926 927 928 929 930 931 1168 1169 1170 913 914 915 916 917 918 922 923 924 925 926 927 928 929 930 931 1168 1169 1170 
290 5632 3072 6144 2560 932 1171 932 1171 932 1171 
291 5120 2560 5632 2048 894 895 896 897 898 899 900 901 902 903 904 905 906 907 908 909 910 911 912 1164 1165 1166 894 895 896 897 898 899 900 901 902 903 904 905 906 907 908 909 910 911 912 1164 1165 1166 894 895 896 897 898 899 900 901 902 903 904 905 906 907 908 909 910 911 912 1164 1165 1166 
292 5632 2560 6144 2048 1167 1167 1167 
18 6144 4096 8192 2048 
19 4096 2048 6144 0 
20 6144 2048 8192 0 
<End>