0 0 2048 2048 0 
1 0 2048 1024 1024 
2 1024 2048 2048 1024 
3 0 1024 1024 0 
13 0 1024 512 512 
14 512 1024 1024 512 
15 0 512 512 0 1 2 3 4 5 6 7 8 1 2 3 4 5 6 7 8 
16 512 512 1024 0 9 10 11 12 13 14 15 16 9 10 11 12 13 14 15 16 
4 1024 1024 2048 0 
17 1024 1024 1536 512 59 60 61 62 63 72 73 74 75 76 85 86 87 88 89 59 60 61 62 63 72 73 74 75 76 85 86 87 88 89 
18 1536 1024 2048 512 64 65 66 67 68 69 70 71 77 78 79 80 81 82 83 84 90 91 92 93 94 95 96 97 64 65 66 67 68 69 70 71 77 78 79 80 81 82 83 84 90 91 92 93 94 95 96 97 
19 1024 512 1536 0 17 18 19 20 21 22 23 24 33 34 35 36 37 46 47 48 49 50 98 99 100 101 102 103 100 101 102 103 104 105 106 107 108 109 110 111 112 113 17 18 19 20 21 22 23 24 33 34 35 36 37 46 47 48 49 50 98 99 100 101 102 103 104 105 106 107 108 109 110 111 112 113 
20 1536 512 2048 0 25 26 27 28 29 30 31 32 38 39 40 41 42 43 44 45 51 52 53 54 55 56 57 58 114 25 26 27 28 29 30 31 32 38 39 40 41 42 43 44 45 51 52 53 54 55 56 57 58 114 
<End>