0 0 2048 2048 0 
1 0 2048 1024 1024 
2 1024 2048 2048 1024 
3 0 1024 1024 0 
13 0 1024 512 512 
14 512 1024 1024 512 
15 0 512 512 0 1 2 3 4 1 2 3 4 
16 512 512 1024 0 5 6 7 8 5 6 7 8 
4 1024 1024 2048 0 
17 1024 1024 1536 512 29 30 31 35 36 37 40 41 42 29 30 31 35 36 37 40 41 42 
18 1536 1024 2048 512 32 33 34 38 39 43 44 45 46 32 33 34 38 39 43 44 45 46 
19 1024 512 1536 0 9 10 11 12 17 18 19 23 24 25 47 48 49 50 51 52 53 9 10 11 12 17 18 19 23 24 25 47 48 49 50 51 52 53 
20 1536 512 2048 0 13 14 15 16 20 21 22 26 27 28 -1 13 14 15 16 20 21 22 26 27 28 54 
<End>