0 0 8192 8192 0 
1 0 8192 4096 4096 
5 0 8192 2048 6144 
6 2048 8192 4096 6144 
7 0 6144 2048 4096 
8 2048 6144 4096 4096 
33 2048 6144 3072 5120 
34 3072 6144 4096 5120 
35 2048 5120 3072 4096 
141 2048 5120 2560 4608 
142 2560 5120 3072 4608 
143 2048 4608 2560 4096 625 626 627 628 
144 2560 4608 3072 4096 1271 
36 3072 5120 4096 4096 
145 3072 5120 3584 4608 
146 3584 5120 4096 4608 
147 3072 4608 3584 4096 380 381 382 383 384 385 386 387 388 389 681 
148 3584 4608 4096 4096 
2 4096 8192 8192 4096 
3 0 4096 4096 0 
13 0 4096 2048 2048 
53 0 4096 1024 3072 
54 1024 4096 2048 3072 
55 0 3072 1024 2048 
56 1024 3072 2048 2048 
225 1024 3072 1536 2560 
226 1536 3072 2048 2560 
227 1024 2560 1536 2048 
228 1536 2560 2048 2048 1266 
14 2048 4096 4096 2048 
57 2048 4096 3072 3072 
229 2048 4096 2560 3584 614 615 616 617 618 619 622 623 624 933 934 935 936 937 938 939 940 941 942 943 944 945 946 
230 2560 4096 3072 3584 357 358 359 360 361 362 363 364 365 366 367 368 369 370 371 372 373 374 375 605 606 607 608 609 610 611 612 613 634 646 647 648 649 650 651 652 653 654 655 656 657 658 659 660 661 662 663 664 812 925 926 927 928 929 930 931 932 986 996 
231 2048 3584 2560 3072 577 584 585 586 587 588 589 590 591 592 620 621 917 918 919 920 921 922 1028 1029 
232 2560 3584 3072 3072 342 343 344 345 346 347 348 349 350 351 352 353 354 355 356 593 594 595 596 597 598 599 600 601 602 603 604 629 630 631 632 633 635 636 637 638 639 640 641 642 643 644 645 901 902 903 904 913 914 915 916 923 924 995 1270 
58 3072 4096 4096 3072 
233 3072 4096 3584 3584 376 377 378 379 390 391 665 666 667 668 669 670 671 672 673 674 675 676 677 678 679 680 682 683 684 685 686 687 688 689 690 691 692 693 694 695 696 697 698 699 700 706 707 708 709 710 711 712 713 714 715 716 717 718 719 720 721 722 723 724 725 726 734 735 740 741 742 743 778 779 780 781 947 948 
234 3584 4096 4096 3584 392 393 394 395 396 397 398 399 400 401 402 403 404 405 406 407 408 409 410 411 412 413 414 415 416 417 701 702 703 704 705 727 728 729 730 731 732 733 736 744 745 746 813 949 950 951 952 953 954 955 956 957 958 959 960 961 962 963 964 971 972 998 999 1272 
235 3072 3584 3584 3072 737 738 739 747 748 749 750 751 755 756 757 758 759 965 966 967 969 
236 3584 3584 4096 3072 418 419 420 421 422 423 424 425 426 431 432 764 765 766 767 768 769 770 771 772 773 774 775 776 777 968 970 978 979 980 981 982 997 1034 1035 1036 1037 1038 1039 1040 1273 
59 2048 3072 3072 2048 
237 2048 3072 2560 2560 565 576 578 579 580 581 582 583 880 883 884 886 887 888 889 890 891 892 893 894 895 896 897 898 899 900 
238 2560 3072 3072 2560 319 320 321 322 323 324 325 326 327 328 329 330 331 332 333 334 335 336 337 338 339 340 341 553 554 555 557 558 559 560 561 562 563 564 566 567 568 569 570 571 572 573 574 575 810 811 905 906 907 908 909 910 911 912 994 1026 1027 1033 1269 
239 2048 2560 2560 2048 277 278 279 280 281 282 283 284 285 286 492 493 494 495 500 552 881 882 885 1019 1020 1021 1267 
240 2560 2560 3072 2048 299 300 301 302 303 304 305 306 307 308 309 310 311 312 313 314 315 316 317 318 530 531 540 541 542 543 544 545 546 547 548 549 550 551 556 809 870 871 872 873 874 875 876 877 878 879 989 990 1009 1010 1011 1012 1013 1014 1015 1016 1017 1018 1022 1023 1024 1025 1268 
60 3072 3072 4096 2048 
241 3072 3072 3584 2560 752 753 754 760 761 762 763 973 975 977 1058 1059 1060 1061 1062 1063 
242 3584 3072 4096 2560 427 428 429 430 433 434 435 436 437 438 439 440 441 442 443 444 445 974 976 1041 1042 1043 1044 
243 3072 2560 3584 2048 1045 1046 1047 1048 1049 1050 1051 1052 1053 1054 1055 1056 1057 1064 1078 1161 
244 3584 2560 4096 2048 1065 1066 1067 1068 1069 1070 1071 1072 1079 1080 1081 1082 1083 1084 1085 1086 1092 1093 1094 1095 1096 1097 1098 1099 1100 1101 1102 1103 1104 1105 1106 1162 1163 1164 1165 1166 1167 1168 1169 
15 0 2048 2048 0 
61 0 2048 1024 1024 
62 1024 2048 2048 1024 
249 1024 2048 1536 1536 
250 1536 2048 2048 1536 199 200 201 202 203 204 205 206 207 208 209 210 211 249 250 251 252 253 254 255 256 257 258 259 260 261 262 263 264 265 266 267 268 270 271 272 477 478 479 480 481 482 483 484 485 486 487 488 489 808 848 849 850 854 855 856 857 858 859 860 861 862 863 864 865 866 867 868 869 987 988 993 1265 
251 1024 1536 1536 1024 
252 1536 1536 2048 1024 191 192 193 194 195 196 197 198 235 236 238 239 240 241 242 243 244 245 246 247 248 269 465 469 470 471 472 473 474 475 476 805 806 807 838 840 842 844 846 852 984 985 992 1005 1032 1264 
63 0 1024 1024 0 
253 0 1024 512 512 
254 512 1024 1024 512 
255 0 512 512 0 1 2 3 4 5 6 7 8 29 30 31 32 33 34 35 36 57 58 59 60 61 62 63 64 65 66 67 68 69 70 71 72 93 94 95 96 97 98 99 100 101 102 108 109 786 787 790 791 793 794 
256 512 512 1024 0 9 10 11 12 13 14 15 16 37 38 39 40 41 42 43 44 73 74 75 76 77 78 79 80 81 82 83 84 85 86 87 88 103 104 105 106 107 110 111 122 123 788 789 792 795 796 797 798 799 991 1261 
64 1024 1024 2048 0 
257 1024 1024 1536 512 
258 1536 1024 2048 512 181 182 183 184 185 186 187 188 189 190 212 213 214 215 216 217 218 219 220 221 222 223 224 225 226 227 228 229 230 231 232 233 234 237 451 452 453 454 455 456 457 458 459 460 461 462 463 464 466 467 468 802 803 804 823 824 825 826 827 983 1003 1031 1263 
259 1024 512 1536 0 17 18 19 20 21 22 23 45 46 47 48 49 50 51 89 90 91 92 124 125 126 127 128 129 132 133 134 135 136 137 138 139 140 141 142 143 144 782 783 784 785 1000 1001 1002 
260 1536 512 2048 0 24 25 26 27 28 52 53 54 55 56 112 113 114 115 116 117 118 119 120 121 130 131 145 146 147 148 149 150 151 152 153 154 155 156 157 158 159 160 161 162 163 164 165 166 167 168 169 170 171 172 173 174 175 176 177 178 179 180 446 447 448 449 450 800 801 814 815 816 817 818 819 820 821 822 1030 1262 
16 2048 2048 4096 0 
65 2048 2048 3072 1024 
261 2048 2048 2560 1536 273 274 275 276 287 288 490 491 496 497 498 499 501 502 503 504 505 506 507 508 509 510 511 512 513 514 515 851 1007 1008 
262 2560 2048 3072 1536 289 290 291 292 293 294 295 296 297 298 516 517 518 519 520 521 522 523 524 525 526 527 528 529 532 533 534 535 536 537 538 539 
263 2048 1536 2560 1024 839 841 843 845 847 853 1006 
264 2560 1536 3072 1024 
66 3072 2048 4096 1024 
67 2048 1024 3072 0 
269 2048 1024 2560 512 833 834 835 836 837 1004 
270 2560 1024 3072 512 
271 2048 512 2560 0 828 829 830 831 832 
272 2560 512 3072 0 
68 3072 1024 4096 0 
4 4096 4096 8192 0 
17 4096 4096 6144 2048 
69 4096 4096 5120 3072 
70 5120 4096 6144 3072 
71 4096 3072 5120 2048 
285 4096 3072 4608 2560 
286 4608 3072 5120 2560 
287 4096 2560 4608 2048 1073 1074 1075 1076 1077 1087 1088 1089 1090 1091 1107 1108 1109 1110 1111 1112 1113 1114 1115 1116 1117 1118 1119 1120 1121 1158 1170 1171 1172 1173 1174 1221 1222 1223 1224 1225 1274 
288 4608 2560 5120 2048 1122 1123 1124 1125 1126 1127 1128 1129 1130 1131 1132 1133 1134 1135 1136 1137 1226 1227 1228 1229 1230 1231 1232 1233 1234 1235 1236 1237 1238 1239 1240 1241 
72 5120 3072 6144 2048 
289 5120 3072 5632 2560 
290 5632 3072 6144 2560 
291 5120 2560 5632 2048 1138 1139 1140 1141 1142 1143 1144 1145 1146 1147 1148 1149 1150 1151 1152 1153 1242 1243 1244 1245 1246 1247 1248 1249 1250 1251 1252 1253 1254 1255 1256 1257 1275 
292 5632 2560 6144 2048 1154 1155 1156 1157 1159 1160 1175 1176 1177 1178 1179 1180 1181 1182 1183 1184 1185 1186 1205 1206 1207 1208 1209 1210 1215 1216 1217 1218 1219 1220 1258 1259 
18 6144 4096 8192 2048 
73 6144 4096 7168 3072 
74 7168 4096 8192 3072 
75 6144 3072 7168 2048 
301 6144 3072 6656 2560 
302 6656 3072 7168 2560 
303 6144 2560 6656 2048 1187 1188 1189 1190 1191 1192 1193 1194 1195 1196 1197 1198 1199 1200 1201 1202 1203 1204 1211 1212 1213 1214 1260 
304 6656 2560 7168 2048 
76 7168 3072 8192 2048 
19 4096 2048 6144 0 
20 6144 2048 8192 0 
<End>