0 0 8192 8192 0 
1 0 8192 4096 4096 
5 0 8192 2048 6144 
6 2048 8192 4096 6144 
7 0 6144 2048 4096 
8 2048 6144 4096 4096 
33 2048 6144 3072 5120 
34 3072 6144 4096 5120 
35 2048 5120 3072 4096 
141 2048 5120 2560 4608 
142 2560 5120 3072 4608 
143 2048 4608 2560 4096 784 785 786 787 784 785 786 787 784 785 786 787 784 785 786 787 784 785 786 787 
144 2560 4608 3072 4096 
36 3072 5120 4096 4096 
145 3072 5120 3584 4608 
146 3584 5120 4096 4608 
147 3072 4608 3584 4096 412 413 414 415 416 417 418 419 420 421 843 412 413 414 415 416 417 418 419 420 421 843 412 413 414 415 416 417 418 419 420 421 843 412 413 414 415 416 417 418 419 420 421 843 412 413 414 415 416 417 418 419 420 421 843 
148 3584 4608 4096 4096 
2 4096 8192 8192 4096 
3 0 4096 4096 0 
13 0 4096 2048 2048 
14 2048 4096 4096 2048 
57 2048 4096 3072 3072 
229 2048 4096 2560 3584 763 764 765 766 767 768 769 770 771 772 778 779 780 781 782 783 763 764 765 766 767 768 769 770 771 772 778 779 780 781 782 783 763 764 765 766 767 768 769 770 771 772 778 779 780 781 782 783 763 764 765 766 767 768 769 770 771 772 778 779 780 781 782 783 763 764 765 766 767 768 769 770 771 772 778 779 780 781 782 783 
230 2560 4096 3072 3584 389 390 391 392 393 394 395 396 397 398 399 400 401 402 403 404 405 406 407 751 752 753 754 755 756 757 758 759 760 761 793 807 808 809 810 811 812 813 814 815 816 817 818 819 820 821 822 823 824 825 826 389 390 391 392 393 394 395 396 397 398 399 400 401 402 403 404 405 406 407 751 752 753 754 755 756 757 758 759 760 761 793 807 808 809 810 811 812 813 814 815 816 817 818 819 820 821 822 823 824 825 826 389 390 391 392 393 394 395 396 397 398 399 400 401 402 403 404 405 406 407 751 752 753 754 755 756 757 758 759 760 761 793 807 808 809 810 811 812 813 814 815 816 817 818 819 820 821 822 823 824 825 826 389 390 391 392 393 394 395 396 397 398 399 400 401 402 403 404 405 406 407 751 752 753 754 755 756 757 758 759 760 761 793 807 808 809 810 811 812 813 814 815 816 817 818 819 820 821 822 823 824 825 826 389 390 391 392 393 394 395 396 397 398 399 400 401 402 403 404 405 406 407 751 752 753 754 755 756 757 758 759 760 761 793 807 808 809 810 811 812 813 814 815 816 817 818 819 820 821 822 823 824 825 826 
231 2048 3584 2560 3072 715 722 723 724 725 726 727 728 729 730 731 773 774 775 776 777 715 722 723 724 725 726 727 728 729 730 731 773 774 775 776 777 715 722 723 724 725 726 727 728 729 730 731 773 774 775 776 777 715 722 723 724 725 726 727 728 729 730 731 773 774 775 776 777 715 722 723 724 725 726 727 728 729 730 731 773 774 775 776 777 
232 2560 3584 3072 3072 374 375 376 377 378 379 380 381 382 383 384 385 386 387 388 736 737 738 739 740 741 742 743 744 745 746 747 748 749 750 788 789 790 791 792 794 795 796 797 798 799 800 801 802 803 804 805 806 374 375 376 377 378 379 380 381 382 383 384 385 386 387 388 736 737 738 739 740 741 742 743 744 745 746 747 748 749 750 788 789 790 791 792 794 795 796 797 798 799 800 801 802 803 804 805 806 374 375 376 377 378 379 380 381 382 383 384 385 386 387 388 736 737 738 739 740 741 742 743 744 745 746 747 748 749 750 788 789 790 791 792 794 795 796 797 798 799 800 801 802 803 804 805 806 374 375 376 377 378 379 380 381 382 383 384 385 386 387 388 736 737 738 739 740 741 742 743 744 745 746 747 748 749 750 788 789 790 791 792 794 795 796 797 798 799 800 801 802 803 804 805 806 374 375 376 377 378 379 380 381 382 383 384 385 386 387 388 736 737 738 739 740 741 742 743 744 745 746 747 748 749 750 788 789 790 791 792 794 795 796 797 798 799 800 801 802 803 804 805 806 
58 3072 4096 4096 3072 
233 3072 4096 3584 3584 408 409 410 411 422 423 827 828 829 830 831 832 833 834 835 836 837 838 839 840 841 842 844 845 846 847 848 849 850 851 852 853 854 860 861 862 863 864 865 866 867 868 874 875 876 877 878 879 880 881 882 883 884 885 886 887 888 889 890 891 892 893 894 905 906 915 916 917 918 1077 1078 1079 1080 408 409 410 411 422 423 827 828 829 830 831 832 833 834 835 836 837 838 839 840 841 842 844 845 846 847 848 849 850 851 852 853 854 860 861 862 863 864 865 866 867 868 874 875 876 877 878 879 880 881 882 883 884 885 886 887 888 889 890 891 892 893 894 905 906 915 916 917 918 1077 1078 1079 1080 408 409 410 411 422 423 827 828 829 830 831 832 833 834 835 836 837 838 839 840 841 842 844 845 846 847 848 849 850 851 852 853 854 860 861 862 863 864 865 866 867 868 874 875 876 877 878 879 880 881 882 883 884 885 886 887 888 889 890 891 892 893 894 905 906 915 916 917 918 1077 1078 1079 1080 408 409 410 411 422 423 827 828 829 830 831 832 833 834 835 836 837 838 839 840 841 842 844 845 846 847 848 849 850 851 852 853 854 860 861 862 863 864 865 866 867 868 874 875 876 877 878 879 880 881 882 883 884 885 886 887 888 889 890 891 892 893 894 905 906 915 916 917 918 1077 1078 1079 1080 408 409 410 411 422 423 827 828 829 830 831 832 833 834 835 836 837 838 839 840 841 842 844 845 846 847 848 849 850 851 852 853 854 860 861 862 863 864 865 866 867 868 874 875 876 877 878 879 880 881 882 883 884 885 886 887 888 889 890 891 892 893 894 905 906 915 916 917 918 1077 1078 1079 1080 
234 3584 4096 4096 3584 424 425 426 427 428 429 430 431 432 433 434 435 436 437 438 439 440 441 442 443 444 445 446 447 448 449 450 451 452 855 856 857 858 859 869 870 871 872 873 895 896 897 898 899 900 901 902 903 904 907 908 919 920 921 922 424 425 426 427 428 429 430 431 432 433 434 435 436 437 438 439 440 441 442 443 444 445 446 447 448 449 450 451 452 855 856 857 858 859 869 870 871 872 873 895 896 897 898 899 900 901 902 903 904 907 908 919 920 921 922 424 425 426 427 428 429 430 431 432 433 434 435 436 437 438 439 440 441 442 443 444 445 446 447 448 449 450 451 452 855 856 857 858 859 869 870 871 872 873 895 896 897 898 899 900 901 902 903 904 907 908 919 920 921 922 424 425 426 427 428 429 430 431 432 433 434 435 436 437 438 439 440 441 442 443 444 445 446 447 448 449 450 451 452 855 856 857 858 859 869 870 871 872 873 895 896 897 898 899 900 901 902 903 904 907 908 919 920 921 922 424 425 426 427 428 429 430 431 432 433 434 435 436 437 438 439 440 441 442 443 444 445 446 447 448 449 450 451 452 855 856 857 858 859 869 870 871 872 873 895 896 897 898 899 900 901 902 903 904 907 908 919 920 921 922 
235 3072 3584 3584 3072 909 910 911 912 913 914 923 924 925 926 927 934 935 936 937 938 909 910 911 912 913 914 923 924 925 926 927 934 935 936 937 938 909 910 911 912 913 914 923 924 925 926 927 934 935 936 937 938 909 910 911 912 913 914 923 924 925 926 927 934 935 936 937 938 909 910 911 912 913 914 923 924 925 926 927 934 935 936 937 938 
236 3584 3584 4096 3072 453 454 455 456 457 458 459 460 461 462 463 468 469 1058 1059 1060 1061 1062 1063 1064 1065 1066 1067 1068 1069 1070 1071 1072 1073 1074 1075 1076 453 454 455 456 457 458 459 460 461 462 463 468 469 1058 1059 1060 1061 1062 1063 1064 1065 1066 1067 1068 1069 1070 1071 1072 1073 1074 1075 1076 453 454 455 456 457 458 459 460 461 462 463 468 469 1058 1059 1060 1061 1062 1063 1064 1065 1066 1067 1068 1069 1070 1071 1072 1073 1074 1075 1076 453 454 455 456 457 458 459 460 461 462 463 468 469 1058 1059 1060 1061 1062 1063 1064 1065 1066 1067 1068 1069 1070 1071 1072 1073 1074 1075 1076 453 454 455 456 457 458 459 460 461 462 463 468 469 1058 1059 1060 1061 1062 1063 1064 1065 1066 1067 1068 1069 1070 1071 1072 1073 1074 1075 1076 
59 2048 3072 3072 2048 
237 2048 3072 2560 2560 691 692 693 694 695 696 699 700 701 702 714 716 717 718 719 720 721 691 692 693 694 695 696 699 700 701 702 714 716 717 718 719 720 721 691 692 693 694 695 696 699 700 701 702 714 716 717 718 719 720 721 691 692 693 694 695 696 699 700 701 702 714 716 717 718 719 720 721 691 692 693 694 695 696 699 700 701 702 714 716 717 718 719 720 721 
238 2560 3072 3072 2560 350 351 352 353 354 355 356 357 358 359 360 361 362 363 364 365 366 367 368 369 370 371 372 373 677 678 679 682 683 684 685 686 687 688 689 690 703 704 705 706 707 708 709 710 711 712 713 732 733 734 735 350 351 352 353 354 355 356 357 358 359 360 361 362 363 364 365 366 367 368 369 370 371 372 373 677 678 679 682 683 684 685 686 687 688 689 690 703 704 705 706 707 708 709 710 711 712 713 732 733 734 735 350 351 352 353 354 355 356 357 358 359 360 361 362 363 364 365 366 367 368 369 370 371 372 373 677 678 679 682 683 684 685 686 687 688 689 690 703 704 705 706 707 708 709 710 711 712 713 732 733 734 735 350 351 352 353 354 355 356 357 358 359 360 361 362 363 364 365 366 367 368 369 370 371 372 373 677 678 679 682 683 684 685 686 687 688 689 690 703 704 705 706 707 708 709 710 711 712 713 732 733 734 735 350 351 352 353 354 355 356 357 358 359 360 361 362 363 364 365 366 367 368 369 370 371 372 373 677 678 679 682 683 684 685 686 687 688 689 690 703 704 705 706 707 708 709 710 711 712 713 732 733 734 735 
239 2048 2560 2560 2048 308 309 310 311 312 313 314 315 316 317 596 597 598 599 604 662 668 669 670 671 697 698 308 309 310 311 312 313 314 315 316 317 596 597 598 599 604 662 668 669 670 671 697 698 308 309 310 311 312 313 314 315 316 317 596 597 598 599 604 662 668 669 670 671 697 698 308 309 310 311 312 313 314 315 316 317 596 597 598 599 604 662 668 669 670 671 697 698 308 309 310 311 312 313 314 315 316 317 596 597 598 599 604 662 668 669 670 671 697 698 
240 2560 2560 3072 2048 330 331 332 333 334 335 336 337 338 339 340 341 342 343 344 345 346 347 348 349 634 635 644 645 646 647 648 649 650 651 652 653 654 655 656 657 658 659 660 661 663 664 665 666 667 672 673 674 675 676 680 681 330 331 332 333 334 335 336 337 338 339 340 341 342 343 344 345 346 347 348 349 634 635 644 645 646 647 648 649 650 651 652 653 654 655 656 657 658 659 660 661 663 664 665 666 667 672 673 674 675 676 680 681 330 331 332 333 334 335 336 337 338 339 340 341 342 343 344 345 346 347 348 349 634 635 644 645 646 647 648 649 650 651 652 653 654 655 656 657 658 659 660 661 663 664 665 666 667 672 673 674 675 676 680 681 330 331 332 333 334 335 336 337 338 339 340 341 342 343 344 345 346 347 348 349 634 635 644 645 646 647 648 649 650 651 652 653 654 655 656 657 658 659 660 661 663 664 665 666 667 672 673 674 675 676 680 681 330 331 332 333 334 335 336 337 338 339 340 341 342 343 344 345 346 347 348 349 634 635 644 645 646 647 648 649 650 651 652 653 654 655 656 657 658 659 660 661 663 664 665 666 667 672 673 674 675 676 680 681 
60 3072 3072 4096 2048 
241 3072 3072 3584 2560 928 929 930 931 932 933 939 940 941 942 943 944 945 946 947 948 949 928 929 930 931 932 933 939 940 941 942 943 944 945 946 947 948 949 928 929 930 931 932 933 939 940 941 942 943 944 945 946 947 948 949 928 929 930 931 932 933 939 940 941 942 943 944 945 946 947 948 949 928 929 930 931 932 933 939 940 941 942 943 944 945 946 947 948 949 
242 3584 3072 4096 2560 464 465 466 467 470 471 472 473 474 475 476 477 478 479 480 481 482 483 484 464 465 466 467 470 471 472 473 474 475 476 477 478 479 480 481 482 483 484 464 465 466 467 470 471 472 473 474 475 476 477 478 479 480 481 482 483 484 464 465 466 467 470 471 472 473 474 475 476 477 478 479 480 481 482 483 484 464 465 466 467 470 471 472 473 474 475 476 477 478 479 480 481 482 483 484 
243 3072 2560 3584 2048 951 953 957 978 979 951 953 957 978 979 951 953 957 978 979 951 953 957 978 979 951 953 957 978 979 
244 3584 2560 4096 2048 485 486 487 488 489 490 491 492 493 494 495 950 952 954 955 956 980 981 982 983 984 985 986 987 988 989 990 991 992 993 999 1000 485 486 487 488 489 490 491 492 493 494 495 950 952 954 955 956 980 981 982 983 984 985 986 987 988 989 990 991 992 993 999 1000 485 486 487 488 489 490 491 492 493 494 495 950 952 954 955 956 980 981 982 983 984 985 986 987 988 989 990 991 992 993 999 1000 485 486 487 488 489 490 491 492 493 494 495 950 952 954 955 956 980 981 982 983 984 985 986 987 988 989 990 991 992 993 999 1000 485 486 487 488 489 490 491 492 493 494 495 950 952 954 955 956 980 981 982 983 984 985 986 987 988 989 990 991 992 993 999 1000 
15 0 2048 2048 0 
61 0 2048 1024 1024 
62 1024 2048 2048 1024 
249 1024 2048 1536 1536 762 762 762 762 762 
250 1536 2048 2048 1536 227 228 229 230 231 232 233 234 235 236 237 238 239 240 279 280 281 282 283 284 285 286 287 288 289 290 291 292 293 294 295 296 297 298 299 301 302 303 572 573 574 575 576 577 578 579 580 581 582 583 584 585 586 587 588 589 590 591 592 593 227 228 229 230 231 232 233 234 235 236 237 238 239 240 279 280 281 282 283 284 285 286 287 288 289 290 291 292 293 294 295 296 297 298 299 301 302 303 572 573 574 575 576 577 578 579 580 581 582 583 584 585 586 587 588 589 590 591 592 593 227 228 229 230 231 232 233 234 235 236 237 238 239 240 279 280 281 282 283 284 285 286 287 288 289 290 291 292 293 294 295 296 297 298 299 301 302 303 572 573 574 575 576 577 578 579 580 581 582 583 584 585 586 587 588 589 590 591 592 593 227 228 229 230 231 232 233 234 235 236 237 238 239 240 279 280 281 282 283 284 285 286 287 288 289 290 291 292 293 294 295 296 297 298 299 301 302 303 572 573 574 575 576 577 578 579 580 581 582 583 584 585 586 587 588 589 590 591 592 593 227 228 229 230 231 232 233 234 235 236 237 238 239 240 279 280 281 282 283 284 285 286 287 288 289 290 291 292 293 294 295 296 297 298 299 301 302 303 572 573 574 575 576 577 578 579 580 581 582 583 584 585 586 587 588 589 590 591 592 593 
251 1024 1536 1536 1024 
252 1536 1536 2048 1024 212 213 214 215 216 217 218 219 220 221 222 223 224 225 226 264 265 267 268 269 270 271 272 273 274 275 276 277 278 300 559 563 564 565 566 567 568 569 570 571 212 213 214 215 216 217 218 219 220 221 222 223 224 225 226 264 265 267 268 269 270 271 272 273 274 275 276 277 278 300 559 563 564 565 566 567 568 569 570 571 212 213 214 215 216 217 218 219 220 221 222 223 224 225 226 264 265 267 268 269 270 271 272 273 274 275 276 277 278 300 559 563 564 565 566 567 568 569 570 571 212 213 214 215 216 217 218 219 220 221 222 223 224 225 226 264 265 267 268 269 270 271 272 273 274 275 276 277 278 300 559 563 564 565 566 567 568 569 570 571 212 213 214 215 216 217 218 219 220 221 222 223 224 225 226 264 265 267 268 269 270 271 272 273 274 275 276 277 278 300 559 563 564 565 566 567 568 569 570 571 
63 0 1024 1024 0 
253 0 1024 512 512 
254 512 1024 1024 512 1090 1090 1090 1090 1090 
255 0 512 512 0 1 2 3 4 5 6 7 8 29 30 31 32 33 34 35 36 57 58 59 60 61 62 63 64 65 66 67 68 69 70 71 72 93 94 95 96 97 98 99 100 101 102 103 104 105 106 116 117 120 121 1087 1088 1089 1 2 3 4 5 6 7 8 29 30 31 32 33 34 35 36 57 58 59 60 61 62 63 64 65 66 67 68 69 70 71 72 93 94 95 96 97 98 99 100 101 102 103 104 105 106 116 117 120 121 1087 1088 1089 1 2 3 4 5 6 7 8 29 30 31 32 33 34 35 36 57 58 59 60 61 62 63 64 65 66 67 68 69 70 71 72 93 94 95 96 97 98 99 100 101 102 103 104 105 106 116 117 120 121 1087 1088 1089 1 2 3 4 5 6 7 8 29 30 31 32 33 34 35 36 57 58 59 60 61 62 63 64 65 66 67 68 69 70 71 72 93 94 95 96 97 98 99 100 101 102 103 104 105 106 116 117 1087 1088 1089 1091 1092 1 2 3 4 5 6 7 8 29 30 31 32 33 34 35 36 57 58 59 60 61 62 63 64 65 66 67 68 69 70 71 72 93 94 95 96 97 98 99 100 101 102 103 104 105 106 116 117 1087 1088 1089 1091 1092 
256 512 512 1024 0 9 10 11 12 13 14 15 16 37 38 39 40 41 42 43 44 73 74 75 76 77 78 79 80 81 82 83 84 85 86 87 88 107 108 108 107 108 109 110 111 112 113 114 115 118 119 130 131 1087 1088 9 10 11 12 13 14 15 16 37 38 39 40 41 42 43 44 73 74 75 76 77 78 79 80 81 82 83 84 85 86 87 88 107 108 108 107 108 109 110 111 112 113 114 115 118 119 130 131 1087 1088 9 10 11 12 13 14 15 16 37 38 39 40 41 42 43 44 73 74 75 76 77 78 79 80 81 82 83 84 85 86 87 88 107 108 107 108 109 110 111 112 113 114 115 118 119 130 131 1087 1088 9 10 11 12 13 14 15 16 37 38 39 40 41 42 43 44 73 74 75 76 77 78 79 80 81 82 83 84 85 86 87 88 107 108 107 108 109 110 111 112 113 114 115 118 119 130 131 1093 1094 9 10 11 12 13 14 15 16 37 38 39 40 41 42 43 44 73 74 75 76 77 78 79 80 81 82 83 84 85 86 87 88 107 108 109 110 111 112 113 114 115 118 119 130 131 1093 1094 1095 1096 
64 1024 1024 2048 0 
257 1024 1024 1536 512 
258 1536 1024 2048 512 196 197 198 199 200 201 202 203 204 205 206 207 208 209 210 211 241 242 243 244 245 246 247 248 249 250 251 252 253 254 255 256 257 258 259 260 261 262 263 266 545 546 547 548 549 550 551 552 553 554 555 556 557 558 560 561 562 196 197 198 199 200 201 202 203 204 205 206 207 208 209 210 211 241 242 243 244 245 246 247 248 249 250 251 252 253 254 255 256 257 258 259 260 261 262 263 266 545 546 547 548 549 550 551 552 553 554 555 556 557 558 560 561 562 196 197 198 199 200 201 202 203 204 205 206 207 208 209 210 211 241 242 243 244 245 246 247 248 249 250 251 252 253 254 255 256 257 258 259 260 261 262 263 266 545 546 547 548 549 550 551 552 553 554 555 556 557 558 560 561 562 196 197 198 199 200 201 202 203 204 205 206 207 208 209 210 211 241 242 243 244 245 246 247 248 249 250 251 252 253 254 255 256 257 258 259 260 261 262 263 266 545 546 547 548 549 550 551 552 553 554 555 556 557 558 560 561 562 196 197 198 199 200 201 202 203 204 205 206 207 208 209 210 211 241 242 243 244 245 246 247 248 249 250 251 252 253 254 255 256 257 258 259 260 261 262 263 266 545 546 547 548 549 550 551 552 553 554 555 556 557 558 560 561 562 
259 1024 512 1536 0 17 18 19 20 21 22 23 45 46 47 48 49 50 51 89 90 91 92 132 133 134 135 136 137 140 141 142 143 144 145 146 147 148 149 150 151 152 153 154 1081 1082 1083 1084 1085 1086 17 18 19 20 21 22 23 45 46 47 48 49 50 51 89 90 91 92 132 133 134 135 136 137 140 141 142 143 144 145 146 147 148 149 150 151 152 153 154 1081 1082 1083 1084 1085 1086 17 18 19 20 21 22 23 45 46 47 48 49 50 51 89 90 91 92 132 133 134 135 136 137 140 141 142 143 144 145 146 147 148 149 150 151 152 153 154 1081 1082 1083 1084 1085 1086 17 18 19 20 21 22 23 45 46 47 48 49 50 51 89 90 91 92 132 133 134 135 136 137 140 141 142 143 144 145 146 147 148 149 150 151 152 153 154 1081 1082 1083 1084 1085 1086 17 18 19 20 21 22 23 45 46 47 48 49 50 51 89 90 91 92 132 133 134 135 136 137 140 141 142 143 144 145 146 147 148 149 150 151 152 153 154 1081 1082 1083 1084 1085 1086 
260 1536 512 2048 0 24 25 26 27 28 52 53 54 55 56 120 121 122 123 124 125 126 127 128 129 138 139 155 156 157 158 159 160 161 162 163 164 165 166 167 168 169 170 171 172 173 174 175 176 177 178 179 180 181 182 183 184 185 186 187 188 189 190 191 192 193 194 195 540 541 542 543 544 24 25 26 27 28 52 53 54 55 56 120 121 122 123 124 125 126 127 128 129 138 139 155 156 157 158 159 160 161 162 163 164 165 166 167 168 169 170 171 172 173 174 175 176 177 178 179 180 181 182 183 184 185 186 187 188 189 190 191 192 193 194 195 540 541 542 543 544 24 25 26 27 28 52 53 54 55 56 120 121 122 123 124 125 126 127 128 129 138 139 155 156 157 158 159 160 161 162 163 164 165 166 167 168 169 170 171 172 173 174 175 176 177 178 179 180 181 182 183 184 185 186 187 188 189 190 191 192 193 194 195 540 541 542 543 544 24 25 26 27 28 52 53 54 55 56 120 121 122 123 124 125 126 127 128 129 138 139 155 156 157 158 159 160 161 162 163 164 165 166 167 168 169 170 171 172 173 174 175 176 177 178 179 180 181 182 183 184 185 186 187 188 189 190 191 192 193 194 195 540 541 542 543 544 24 25 26 27 28 52 53 54 55 56 120 121 122 123 124 125 126 127 128 129 138 139 155 156 157 158 159 160 161 162 163 164 165 166 167 168 169 170 171 172 173 174 175 176 177 178 179 180 181 182 183 184 185 186 187 188 189 190 191 192 193 194 195 540 541 542 543 544 
16 2048 2048 4096 0 
65 2048 2048 3072 1024 
261 2048 2048 2560 1536 304 305 306 307 318 319 594 595 600 601 602 603 605 606 607 608 609 610 611 612 613 614 615 616 617 618 619 304 305 306 307 318 319 594 595 600 601 602 603 605 606 607 608 609 610 611 612 613 614 615 616 617 618 619 304 305 306 307 318 319 594 595 600 601 602 603 605 606 607 608 609 610 611 612 613 614 615 616 617 618 619 304 305 306 307 318 319 594 595 600 601 602 603 605 606 607 608 609 610 611 612 613 614 615 616 617 618 619 304 305 306 307 318 319 594 595 600 601 602 603 605 606 607 608 609 610 611 612 613 614 615 616 617 618 619 
262 2560 2048 3072 1536 320 321 322 323 324 325 326 327 328 329 620 621 622 623 624 625 626 627 628 629 630 631 632 633 636 637 638 639 640 641 642 643 320 321 322 323 324 325 326 327 328 329 620 621 622 623 624 625 626 627 628 629 630 631 632 633 636 637 638 639 640 641 642 643 320 321 322 323 324 325 326 327 328 329 620 621 622 623 624 625 626 627 628 629 630 631 632 633 636 637 638 639 640 641 642 643 320 321 322 323 324 325 326 327 328 329 620 621 622 623 624 625 626 627 628 629 630 631 632 633 636 637 638 639 640 641 642 643 320 321 322 323 324 325 326 327 328 329 620 621 622 623 624 625 626 627 628 629 630 631 632 633 636 637 638 639 640 641 642 643 
263 2048 1536 2560 1024 
264 2560 1536 3072 1024 
66 3072 2048 4096 1024 
67 2048 1024 3072 0 
68 3072 1024 4096 0 
4 4096 4096 8192 0 
17 4096 4096 6144 2048 
69 4096 4096 5120 3072 
70 5120 4096 6144 3072 
71 4096 3072 5120 2048 
285 4096 3072 4608 2560 
286 4608 3072 5120 2560 526 527 528 529 530 531 532 533 534 535 536 537 538 539 1006 1007 1008 1009 1010 1044 1045 1046 526 527 528 529 530 531 532 533 534 535 536 537 538 539 1006 1007 1008 1009 1010 1044 1045 1046 526 527 528 529 530 531 532 533 534 535 536 537 538 539 1006 1007 1008 1009 1010 1044 1045 1046 526 527 528 529 530 531 532 533 534 535 536 537 538 539 1006 1007 1008 1009 1010 1044 1045 1046 526 527 528 529 530 531 532 533 534 535 536 537 538 539 1006 1007 1008 1009 1010 1044 1045 1046 
287 4096 2560 4608 2048 496 497 498 499 500 501 502 503 504 505 506 507 508 509 510 511 958 959 960 961 962 963 994 995 996 997 998 1001 1002 1003 1004 1005 496 497 498 499 500 501 502 503 504 505 506 507 508 509 510 511 958 959 960 961 962 963 994 995 996 997 998 1001 1002 1003 1004 1005 496 497 498 499 500 501 502 503 504 505 506 507 508 509 510 511 958 959 960 961 962 963 994 995 996 997 998 1001 1002 1003 1004 1005 496 497 498 499 500 501 502 503 504 505 506 507 508 509 510 511 958 959 960 961 962 963 994 995 996 997 998 1001 1002 1003 1004 1005 496 497 498 499 500 501 502 503 504 505 506 507 508 509 510 511 958 959 960 961 962 963 994 995 996 997 998 1001 1002 1003 1004 1005 
288 4608 2560 5120 2048 512 513 514 515 516 517 518 519 520 521 522 523 524 525 964 965 966 967 968 969 970 971 972 973 974 975 976 977 1011 1012 1013 1014 512 513 514 515 516 517 518 519 520 521 522 523 524 525 964 965 966 967 968 969 970 971 972 973 974 975 976 977 1011 1012 1013 1014 512 513 514 515 516 517 518 519 520 521 522 523 524 525 964 965 966 967 968 969 970 971 972 973 974 975 976 977 1011 1012 1013 1014 512 513 514 515 516 517 518 519 520 521 522 523 524 525 964 965 966 967 968 969 970 971 972 973 974 975 976 977 1011 1012 1013 1014 512 513 514 515 516 517 518 519 520 521 522 523 524 525 964 965 966 967 968 969 970 971 972 973 974 975 976 977 1011 1012 1013 1014 
72 5120 3072 6144 2048 
289 5120 3072 5632 2560 1036 1037 1038 1039 1040 1041 1042 1043 1047 1048 1049 1050 1051 1052 1053 1054 1055 1056 1036 1037 1038 1039 1040 1041 1042 1043 1047 1048 1049 1050 1051 1052 1053 1054 1055 1056 1036 1037 1038 1039 1040 1041 1042 1043 1047 1048 1049 1050 1051 1052 1053 1054 1055 1056 1036 1037 1038 1039 1040 1041 1042 1043 1047 1048 1049 1050 1051 1052 1053 1054 1055 1056 1036 1037 1038 1039 1040 1041 1042 1043 1047 1048 1049 1050 1051 1052 1053 1054 1055 1056 
290 5632 3072 6144 2560 1057 1057 1057 1057 1057 
291 5120 2560 5632 2048 1015 1016 1017 1018 1019 1020 1021 1022 1023 1024 1025 1026 1027 1028 1029 1030 1031 1032 1033 1034 1035 1015 1016 1017 1018 1019 1020 1021 1022 1023 1024 1025 1026 1027 1028 1029 1030 1031 1032 1033 1034 1035 1015 1016 1017 1018 1019 1020 1021 1022 1023 1024 1025 1026 1027 1028 1029 1030 1031 1032 1033 1034 1035 1015 1016 1017 1018 1019 1020 1021 1022 1023 1024 1025 1026 1027 1028 1029 1030 1031 1032 1033 1034 1035 1015 1016 1017 1018 1019 1020 1021 1022 1023 1024 1025 1026 1027 1028 1029 1030 1031 1032 1033 1034 1035 
292 5632 2560 6144 2048 
18 6144 4096 8192 2048 
19 4096 2048 6144 0 
20 6144 2048 8192 0 
<End>