0 0 8192 8192 0 
1 0 8192 4096 4096 
5 0 8192 2048 6144 
6 2048 8192 4096 6144 
7 0 6144 2048 4096 
8 2048 6144 4096 4096 
33 2048 6144 3072 5120 
34 3072 6144 4096 5120 
35 2048 5120 3072 4096 
36 3072 5120 4096 4096 
145 3072 5120 3584 4608 
146 3584 5120 4096 4608 
147 3072 4608 3584 4096 
148 3584 4608 4096 4096 210 
2 4096 8192 8192 4096 
9 4096 8192 6144 6144 
10 6144 8192 8192 6144 
11 4096 6144 6144 4096 
45 4096 6144 5120 5120 
46 5120 6144 6144 5120 
47 4096 5120 5120 4096 
189 4096 5120 4608 4608 
190 4608 5120 5120 4608 209 
191 4096 4608 4608 4096 
192 4608 4608 5120 4096 208 
48 5120 5120 6144 4096 
12 6144 6144 8192 4096 
3 0 4096 4096 0 
13 0 4096 2048 2048 
14 2048 4096 4096 2048 
15 0 2048 2048 0 
61 0 2048 1024 1024 
62 1024 2048 2048 1024 
249 1024 2048 1536 1536 206 206 
250 1536 2048 2048 1536 
251 1024 1536 1536 1024 
252 1536 1536 2048 1024 
63 0 1024 1024 0 
253 0 1024 512 512 
254 512 1024 1024 512 
255 0 512 512 0 1 2 3 4 5 6 7 8 9 10 11 12 13 14 15 16 200 201 1 2 3 4 5 6 7 8 9 10 11 12 13 14 15 16 200 201 1 2 3 4 5 6 7 8 9 10 11 12 13 14 15 16 200 201 
256 512 512 1024 0 17 18 19 20 21 22 23 24 25 26 27 28 29 30 31 32 17 18 19 20 21 22 23 24 25 26 27 28 29 30 31 32 17 18 19 20 21 22 23 24 25 26 27 28 29 30 31 32 
64 1024 1024 2048 0 
257 1024 1024 1536 512 
258 1536 1024 2048 512 
259 1024 512 1536 0 33 34 35 36 37 38 39 40 41 42 43 44 45 46 47 48 33 34 35 36 37 38 39 40 41 42 43 44 45 46 47 48 33 34 35 36 37 38 39 40 41 42 43 44 45 46 47 48 
260 1536 512 2048 0 49 50 51 52 53 54 55 56 57 58 59 60 61 62 63 64 49 50 51 52 53 54 55 56 57 58 59 60 61 62 63 64 202 49 50 51 52 53 54 55 56 57 58 59 60 61 62 63 64 202 
16 2048 2048 4096 0 
65 2048 2048 3072 1024 
261 2048 2048 2560 1536 
262 2560 2048 3072 1536 205 205 
263 2048 1536 2560 1024 204 204 
264 2560 1536 3072 1024 
66 3072 2048 4096 1024 
67 2048 1024 3072 0 
269 2048 1024 2560 512 203 203 
270 2560 1024 3072 512 
271 2048 512 2560 0 65 66 67 68 69 70 71 72 73 74 75 76 77 78 79 80 65 66 67 68 69 70 71 72 73 74 75 76 77 78 79 80 65 66 67 68 69 70 71 72 73 74 75 76 77 78 79 80 
272 2560 512 3072 0 81 82 83 84 85 86 87 88 89 90 91 92 93 94 95 96 81 82 83 84 85 86 87 88 89 90 91 92 93 94 95 96 81 82 83 84 85 86 87 88 89 90 91 92 93 94 95 96 
68 3072 1024 4096 0 
273 3072 1024 3584 512 
274 3584 1024 4096 512 
275 3072 512 3584 0 97 98 99 100 101 102 103 104 105 106 107 108 109 110 111 112 97 98 99 100 101 102 103 104 105 106 107 108 109 110 111 112 97 98 99 100 101 102 103 104 105 106 107 108 109 110 111 112 
276 3584 512 4096 0 113 114 115 116 117 118 119 120 121 122 123 124 125 126 127 128 113 114 115 116 117 118 119 120 121 122 123 124 125 126 127 128 113 114 115 116 117 118 119 120 121 122 123 124 125 126 127 128 
4 4096 4096 8192 0 
17 4096 4096 6144 2048 
18 6144 4096 8192 2048 
19 4096 2048 6144 0 
77 4096 2048 5120 1024 
78 5120 2048 6144 1024 
313 5120 2048 5632 1536 
314 5632 2048 6144 1536 207 207 
315 5120 1536 5632 1024 
316 5632 1536 6144 1024 
79 4096 1024 5120 0 
317 4096 1024 4608 512 
318 4608 1024 5120 512 
319 4096 512 4608 0 129 130 131 132 133 134 135 136 137 138 139 140 141 142 143 144 129 130 131 132 133 134 135 136 137 138 139 140 141 142 143 144 129 130 131 132 133 134 135 136 137 138 139 140 141 142 143 144 
320 4608 512 5120 0 145 146 147 148 149 150 151 152 153 154 155 156 157 158 159 160 145 146 147 148 149 150 151 152 153 154 155 156 157 158 159 160 145 146 147 148 149 150 151 152 153 154 155 156 157 158 159 160 
80 5120 1024 6144 0 
321 5120 1024 5632 512 
322 5632 1024 6144 512 
323 5120 512 5632 0 161 162 163 164 165 166 167 168 169 170 171 172 173 174 175 176 161 162 163 164 165 166 167 168 169 170 171 172 173 174 175 176 161 162 163 164 165 166 167 168 169 170 171 172 173 174 175 176 
324 5632 512 6144 0 177 178 179 180 181 182 183 184 185 186 187 188 189 190 191 192 177 178 179 180 181 182 183 184 185 186 187 188 189 190 191 192 177 178 179 180 181 182 183 184 185 186 187 188 189 190 191 192 
20 6144 2048 8192 0 
81 6144 2048 7168 1024 
82 7168 2048 8192 1024 
83 6144 1024 7168 0 
333 6144 1024 6656 512 
334 6656 1024 7168 512 
335 6144 512 6656 0 193 194 195 196 197 198 199 193 194 195 196 197 198 199 193 194 195 196 197 198 199 
336 6656 512 7168 0 
84 7168 1024 8192 0 
<End>