#Tile_Matrix
Total_Row	Total_Column	Total_Tile
37	120	1352
#Tile_Matrix_Value
0	0	0	0	1	2	3	4	5	6	0	0	0	7	3	3	3	3	3	3	3	3	3	3	3	3	3	3	3	3	3	3	3	3	3	3	3	3	8	5	0	0	0	0	1	2	3	4	9	6	0	0	0	0	0	0	0	0	0	0	1	2	3	4	5	10	3	3	3	3	3	3	3	3	3	3	3	3	3	11	-1	-1	-1	-1	-1	-1	-1	-1	-1	-1	-1	-1	-1	-1	-1	-1	-1	-1	-1	-1	-1	-1	-1	-1	-1	-1	-1	-1	-1	-1	-1	-1	-1	-1	-1	-1	-1	-1	-1	-1	
0	0	0	0	0	1	12	13	0	0	0	0	14	14	15	16	17	17	17	17	17	17	17	17	18	3	3	3	3	3	3	3	3	3	3	3	3	3	6	0	0	0	0	0	0	1	12	13	19	20	0	14	0	0	0	14	0	0	0	0	0	1	12	13	0	21	3	3	3	3	3	3	3	3	3	3	3	3	3	11	-1	-1	-1	-1	-1	-1	-1	-1	-1	-1	-1	-1	-1	-1	-1	-1	-1	-1	-1	-1	-1	-1	-1	-1	-1	-1	-1	-1	-1	-1	-1	-1	-1	-1	-1	-1	-1	-1	-1	-1	
0	0	0	0	0	0	19	20	0	0	14	14	22	22	23	24	25	25	25	25	25	25	25	25	26	3	3	3	3	3	3	3	3	3	3	3	3	8	0	0	0	0	0	0	0	0	19	20	0	27	28	29	14	0	14	23	0	0	0	0	0	0	19	20	0	30	3	3	3	3	3	3	3	3	3	3	3	3	3	11	-1	-1	-1	-1	-1	-1	-1	-1	-1	-1	-1	-1	-1	-1	-1	-1	-1	-1	-1	-1	-1	-1	-1	-1	-1	-1	-1	-1	-1	-1	-1	-1	-1	-1	-1	-1	-1	-1	-1	-1	
0	0	0	0	0	0	0	31	14	14	22	22	32	32	33	3	3	3	3	16	17	17	17	34	17	17	17	34	18	3	3	3	3	3	3	3	3	6	0	0	0	0	0	0	0	0	0	31	14	14	22	32	29	14	22	33	0	0	0	0	0	0	0	31	14	35	15	15	15	36	37	36	3	15	15	15	15	15	3	11	-1	-1	-1	-1	-1	-1	-1	-1	-1	-1	-1	-1	-1	-1	-1	-1	-1	-1	-1	-1	-1	-1	-1	-1	-1	-1	-1	-1	-1	-1	-1	-1	-1	-1	-1	-1	-1	-1	-1	-1	
0	38	39	40	0	0	14	22	22	22	32	32	32	32	33	3	3	3	3	24	25	25	25	41	25	25	25	41	26	3	3	3	3	3	3	3	8	0	0	0	0	38	39	40	0	0	14	22	22	22	32	32	32	22	32	33	0	38	39	40	0	0	14	22	42	43	44	45	44	46	47	46	3	44	44	45	48	49	50	11	-1	-1	-1	-1	-1	-1	-1	-1	-1	-1	-1	-1	-1	-1	-1	-1	-1	-1	-1	-1	-1	-1	-1	-1	-1	-1	-1	-1	-1	-1	-1	-1	-1	-1	-1	-1	-1	-1	-1	-1	
14	51	52	53	14	14	22	32	32	32	32	32	32	32	33	3	3	3	3	3	3	3	3	16	17	54	17	54	17	54	17	54	17	54	55	3	56	14	14	14	14	51	52	53	14	14	22	32	32	32	32	32	32	32	32	57	14	51	52	53	14	14	22	32	58	0	59	3	59	3	59	3	3	59	59	3	60	61	62	11	-1	-1	-1	-1	-1	-1	-1	-1	-1	-1	-1	-1	-1	-1	-1	-1	-1	-1	-1	-1	-1	-1	-1	-1	-1	-1	-1	-1	-1	-1	-1	-1	-1	-1	-1	-1	-1	-1	-1	-1	
22	22	22	22	22	22	32	32	32	32	32	32	32	32	33	3	3	3	3	3	3	3	3	24	25	63	25	63	25	63	25	63	25	63	64	3	65	22	22	22	22	22	22	22	22	22	32	32	32	32	32	32	32	32	32	32	22	22	22	22	22	22	32	32	58	0	59	3	59	3	59	3	66	67	67	66	68	61	69	11	-1	-1	-1	-1	-1	-1	-1	-1	-1	-1	-1	-1	-1	-1	-1	-1	-1	-1	-1	-1	-1	-1	-1	-1	-1	-1	-1	-1	-1	-1	-1	-1	-1	-1	-1	-1	-1	-1	-1	-1	
-1	-1	-1	-1	-1	-1	-1	-1	-1	-1	-1	-1	-1	-1	-1	-1	-1	-1	-1	-1	-1	-1	-1	-1	-1	-1	-1	-1	-1	-1	-1	-1	-1	-1	-1	-1	-1	-1	-1	-1	-1	-1	-1	-1	-1	-1	-1	-1	-1	-1	-1	-1	-1	-1	-1	-1	-1	-1	-1	-1	-1	-1	-1	-1	-1	-1	-1	-1	-1	-1	-1	-1	70	45	45	45	71	72	73	74	-1	-1	-1	-1	-1	-1	-1	-1	-1	-1	-1	-1	-1	-1	-1	-1	-1	-1	-1	-1	-1	-1	-1	-1	-1	-1	-1	-1	-1	-1	-1	-1	-1	-1	-1	-1	-1	-1	-1	-1	
-1	-1	-1	-1	-1	-1	-1	-1	-1	-1	-1	-1	-1	-1	-1	-1	-1	-1	-1	-1	-1	-1	-1	-1	-1	-1	-1	-1	-1	-1	-1	-1	-1	-1	-1	-1	-1	-1	-1	-1	-1	-1	-1	-1	-1	-1	-1	-1	-1	-1	-1	-1	-1	-1	-1	-1	-1	-1	-1	-1	-1	-1	-1	-1	-1	-1	-1	-1	-1	-1	-1	-1	61	3	3	3	3	3	3	75	-1	-1	-1	-1	-1	-1	-1	-1	-1	-1	-1	-1	-1	-1	-1	-1	-1	-1	-1	-1	-1	-1	-1	-1	-1	-1	-1	-1	-1	-1	-1	-1	-1	-1	-1	-1	-1	-1	-1	-1	
-1	-1	-1	-1	-1	-1	-1	-1	-1	-1	-1	-1	-1	-1	-1	-1	-1	-1	-1	-1	-1	-1	-1	-1	-1	-1	-1	-1	-1	-1	-1	-1	-1	-1	-1	-1	-1	-1	-1	-1	-1	-1	-1	-1	-1	-1	-1	-1	-1	-1	-1	-1	-1	-1	-1	-1	-1	-1	-1	-1	-1	-1	-1	-1	-1	-1	-1	-1	-1	-1	-1	-1	61	3	3	3	3	3	3	75	-1	-1	-1	-1	-1	-1	-1	-1	-1	-1	-1	-1	-1	-1	-1	-1	-1	-1	-1	-1	-1	-1	-1	-1	-1	-1	-1	-1	-1	-1	-1	-1	-1	-1	-1	-1	-1	-1	-1	-1	
-1	-1	-1	-1	-1	-1	-1	-1	-1	-1	-1	-1	-1	-1	-1	-1	-1	-1	-1	-1	-1	-1	-1	-1	-1	-1	-1	-1	-1	-1	-1	-1	-1	-1	-1	-1	-1	-1	-1	-1	-1	-1	-1	-1	-1	-1	-1	-1	-1	-1	-1	-1	-1	-1	-1	-1	-1	-1	-1	-1	-1	-1	-1	-1	-1	-1	-1	-1	-1	-1	-1	-1	76	77	3	78	3	3	3	75	-1	-1	-1	-1	-1	-1	-1	-1	-1	-1	-1	-1	-1	-1	-1	-1	-1	-1	-1	-1	-1	-1	-1	-1	-1	-1	-1	-1	-1	-1	-1	-1	-1	-1	-1	-1	-1	-1	-1	-1	
-1	-1	-1	-1	-1	-1	-1	-1	-1	-1	-1	-1	-1	-1	-1	-1	-1	-1	-1	-1	-1	-1	-1	-1	-1	-1	-1	-1	-1	-1	-1	-1	-1	-1	-1	-1	-1	-1	-1	-1	-1	-1	-1	-1	-1	-1	-1	-1	-1	-1	-1	-1	-1	-1	-1	-1	-1	-1	-1	-1	-1	-1	-1	-1	-1	-1	-1	-1	-1	-1	-1	-1	79	80	3	81	3	78	3	75	-1	-1	-1	-1	-1	-1	-1	-1	-1	-1	-1	-1	-1	-1	-1	-1	-1	-1	-1	-1	-1	-1	-1	-1	-1	-1	-1	-1	-1	-1	-1	-1	-1	-1	-1	-1	-1	-1	-1	-1	
-1	-1	-1	-1	-1	-1	-1	-1	-1	-1	-1	-1	-1	-1	-1	-1	-1	-1	-1	-1	-1	-1	-1	-1	-1	-1	-1	-1	-1	-1	-1	-1	-1	-1	-1	-1	-1	-1	-1	-1	-1	-1	-1	-1	-1	-1	-1	-1	-1	-1	-1	-1	-1	-1	-1	-1	-1	-1	-1	-1	-1	-1	-1	-1	-1	-1	-1	-1	-1	-1	-1	-1	79	80	3	81	3	81	3	75	-1	-1	-1	-1	-1	-1	-1	-1	-1	-1	-1	-1	-1	-1	-1	-1	-1	-1	-1	-1	-1	-1	-1	-1	-1	-1	-1	-1	-1	-1	-1	-1	-1	-1	-1	-1	-1	-1	-1	-1	
-1	-1	-1	-1	-1	-1	-1	-1	-1	-1	-1	-1	-1	-1	-1	-1	-1	-1	-1	-1	-1	-1	-1	-1	-1	-1	-1	-1	-1	-1	-1	-1	-1	-1	-1	-1	-1	-1	-1	-1	-1	-1	-1	-1	-1	-1	-1	-1	-1	-1	-1	-1	-1	-1	-1	-1	-1	-1	-1	-1	-1	-1	-1	-1	-1	-1	-1	-1	-1	-1	-1	-1	79	80	3	81	3	81	3	75	-1	-1	-1	-1	-1	-1	-1	-1	-1	-1	-1	-1	-1	-1	-1	-1	-1	-1	-1	-1	-1	-1	-1	-1	-1	-1	-1	-1	-1	-1	-1	-1	-1	-1	-1	-1	-1	-1	-1	-1	
-1	-1	-1	-1	-1	-1	-1	-1	-1	-1	-1	-1	-1	-1	-1	-1	-1	-1	-1	-1	-1	-1	-1	-1	-1	-1	-1	-1	-1	-1	-1	-1	-1	-1	-1	-1	-1	-1	-1	-1	-1	-1	-1	-1	-1	-1	-1	-1	-1	-1	-1	-1	-1	-1	-1	-1	-1	-1	-1	-1	-1	-1	-1	-1	-1	-1	-1	-1	-1	-1	-1	-1	82	80	3	81	3	81	3	83	-1	-1	-1	-1	-1	-1	-1	-1	-1	-1	-1	-1	-1	-1	-1	-1	-1	-1	-1	-1	-1	-1	-1	-1	-1	-1	-1	-1	-1	-1	-1	-1	-1	-1	-1	-1	-1	-1	-1	-1	
-1	-1	-1	-1	-1	-1	-1	-1	-1	-1	-1	-1	-1	-1	-1	-1	-1	-1	-1	-1	-1	-1	-1	-1	-1	-1	-1	-1	-1	-1	-1	-1	-1	-1	-1	-1	-1	-1	-1	-1	-1	-1	-1	-1	-1	-1	-1	-1	-1	-1	-1	-1	-1	-1	-1	-1	-1	-1	-1	-1	-1	-1	-1	-1	-1	-1	-1	-1	-1	-1	-1	-1	33	80	3	81	3	81	3	11	-1	-1	-1	-1	-1	-1	-1	-1	-1	-1	-1	-1	-1	-1	-1	-1	-1	-1	-1	-1	-1	-1	-1	-1	-1	-1	-1	-1	-1	-1	-1	-1	-1	-1	-1	-1	-1	-1	-1	-1	
-1	-1	-1	-1	-1	-1	-1	-1	-1	-1	-1	-1	-1	-1	-1	-1	-1	-1	-1	-1	-1	-1	-1	-1	-1	-1	-1	-1	-1	-1	-1	-1	-1	-1	-1	-1	-1	-1	-1	-1	-1	-1	-1	-1	-1	-1	-1	-1	-1	-1	-1	-1	-1	-1	-1	-1	-1	-1	-1	-1	-1	-1	-1	-1	-1	-1	-1	-1	-1	-1	-1	-1	84	85	3	86	3	86	3	87	-1	-1	-1	-1	-1	-1	-1	-1	-1	-1	-1	-1	-1	-1	-1	-1	-1	-1	-1	-1	-1	-1	-1	-1	-1	-1	-1	-1	-1	-1	-1	-1	-1	-1	-1	-1	-1	-1	-1	-1	
-1	-1	-1	-1	-1	-1	-1	-1	-1	-1	-1	-1	-1	-1	-1	-1	-1	-1	-1	-1	-1	-1	-1	-1	-1	-1	-1	-1	-1	-1	-1	-1	-1	-1	-1	-1	-1	-1	-1	-1	-1	-1	-1	-1	-1	-1	-1	-1	-1	-1	-1	-1	-1	-1	-1	-1	-1	-1	-1	-1	-1	-1	-1	-1	-1	-1	-1	-1	-1	-1	-1	-1	61	3	3	3	3	78	3	75	-1	-1	-1	-1	-1	-1	-1	-1	-1	-1	-1	-1	-1	-1	-1	-1	-1	-1	-1	-1	-1	-1	-1	-1	-1	-1	-1	-1	-1	-1	-1	-1	-1	-1	-1	-1	-1	-1	-1	-1	
-1	-1	-1	-1	-1	-1	-1	-1	-1	-1	-1	-1	-1	-1	-1	-1	-1	-1	-1	-1	-1	-1	-1	-1	-1	-1	-1	-1	-1	-1	-1	-1	-1	-1	-1	-1	-1	-1	-1	-1	-1	-1	-1	-1	-1	-1	-1	-1	-1	-1	-1	-1	-1	-1	-1	-1	-1	-1	-1	-1	-1	-1	-1	-1	-1	-1	-1	-1	-1	-1	-1	-1	88	89	3	3	3	81	3	75	-1	-1	-1	-1	-1	-1	-1	-1	-1	-1	-1	-1	-1	-1	-1	-1	-1	-1	-1	-1	-1	-1	-1	-1	-1	-1	-1	-1	-1	-1	-1	-1	-1	-1	-1	-1	-1	-1	-1	-1	
-1	-1	-1	-1	-1	-1	-1	-1	-1	-1	-1	-1	-1	-1	-1	-1	-1	-1	-1	-1	-1	-1	-1	-1	-1	-1	-1	-1	-1	-1	-1	-1	-1	-1	-1	-1	-1	-1	-1	-1	-1	-1	-1	-1	-1	-1	-1	-1	-1	-1	-1	-1	-1	-1	-1	-1	-1	-1	-1	-1	-1	-1	-1	-1	-1	-1	-1	-1	-1	-1	-1	-1	79	80	90	78	3	91	3	75	-1	-1	-1	-1	-1	-1	-1	-1	-1	-1	-1	-1	-1	-1	-1	-1	-1	-1	-1	-1	-1	-1	-1	-1	-1	-1	-1	-1	-1	-1	-1	-1	-1	-1	-1	-1	-1	-1	-1	-1	
-1	-1	-1	-1	-1	-1	-1	-1	-1	-1	-1	-1	-1	-1	-1	-1	-1	-1	-1	-1	-1	-1	-1	-1	-1	-1	-1	-1	-1	-1	-1	-1	-1	-1	-1	-1	-1	-1	-1	-1	-1	-1	-1	-1	-1	-1	-1	-1	-1	-1	-1	-1	-1	-1	-1	-1	-1	-1	-1	-1	-1	-1	-1	-1	-1	-1	-1	-1	-1	-1	-1	-1	92	93	94	81	3	78	3	75	-1	-1	-1	-1	-1	-1	-1	-1	-1	-1	-1	-1	-1	-1	-1	-1	-1	-1	-1	-1	-1	-1	-1	-1	-1	-1	-1	-1	-1	-1	-1	-1	-1	-1	-1	-1	-1	-1	-1	-1	
-1	-1	-1	-1	-1	-1	-1	-1	-1	-1	-1	-1	-1	-1	-1	-1	-1	-1	-1	-1	-1	-1	-1	-1	-1	-1	-1	-1	-1	-1	-1	-1	-1	-1	-1	-1	-1	-1	-1	-1	-1	-1	-1	-1	-1	-1	-1	-1	-1	-1	-1	-1	-1	-1	-1	-1	-1	-1	-1	-1	-1	-1	-1	-1	-1	-1	-1	-1	-1	-1	-1	-1	95	96	61	81	3	81	3	83	-1	-1	-1	-1	-1	-1	-1	-1	-1	-1	-1	-1	-1	-1	-1	-1	-1	-1	-1	-1	-1	-1	-1	-1	-1	-1	-1	-1	-1	-1	-1	-1	-1	-1	-1	-1	-1	-1	-1	-1	
-1	-1	-1	-1	-1	-1	-1	-1	-1	-1	-1	-1	-1	-1	-1	-1	-1	-1	-1	-1	-1	-1	-1	-1	-1	-1	-1	-1	-1	-1	-1	-1	-1	-1	-1	-1	-1	-1	-1	-1	-1	-1	-1	-1	-1	-1	-1	-1	-1	-1	-1	-1	-1	-1	-1	-1	-1	-1	-1	-1	-1	-1	-1	-1	-1	-1	-1	-1	-1	-1	-1	-1	97	98	99	86	3	86	3	11	-1	-1	-1	-1	-1	-1	-1	-1	-1	-1	-1	-1	-1	-1	-1	-1	-1	-1	-1	-1	-1	-1	-1	-1	-1	-1	-1	-1	-1	-1	-1	-1	-1	-1	-1	-1	-1	-1	-1	-1	
-1	-1	-1	-1	-1	-1	-1	-1	-1	-1	-1	-1	-1	-1	-1	-1	-1	-1	-1	-1	-1	-1	-1	-1	-1	-1	-1	-1	-1	-1	-1	-1	-1	-1	-1	-1	-1	-1	-1	-1	-1	-1	-1	-1	-1	-1	-1	-1	-1	-1	-1	-1	-1	-1	-1	-1	-1	-1	-1	-1	-1	-1	-1	-1	-1	-1	-1	-1	-1	-1	-1	-1	61	3	3	100	3	3	3	11	-1	-1	-1	-1	-1	-1	-1	-1	-1	-1	-1	-1	-1	-1	-1	-1	-1	-1	-1	-1	-1	-1	-1	-1	-1	-1	-1	-1	-1	-1	-1	-1	-1	-1	-1	-1	-1	-1	-1	-1	
-1	-1	-1	-1	-1	-1	-1	-1	-1	-1	-1	-1	-1	-1	-1	-1	-1	-1	-1	-1	-1	-1	-1	-1	-1	-1	-1	-1	-1	-1	-1	-1	-1	-1	-1	-1	-1	-1	-1	-1	-1	-1	-1	-1	-1	-1	-1	-1	-1	-1	-1	-1	-1	-1	-1	-1	-1	-1	-1	-1	-1	-1	-1	-1	-1	-1	-1	-1	-1	-1	-1	-1	101	77	3	81	3	3	3	11	-1	-1	-1	-1	-1	-1	-1	-1	-1	-1	-1	-1	-1	-1	-1	-1	-1	-1	-1	-1	-1	-1	-1	-1	-1	-1	-1	-1	-1	-1	-1	-1	-1	-1	-1	-1	-1	-1	-1	-1	
-1	-1	-1	-1	-1	-1	-1	-1	-1	-1	-1	-1	102	-1	-1	-1	-1	-1	-1	-1	-1	-1	-1	-1	-1	-1	-1	-1	-1	-1	-1	-1	-1	-1	-1	-1	-1	-1	-1	-1	-1	-1	-1	-1	-1	-1	-1	-1	-1	-1	-1	-1	-1	-1	-1	-1	-1	-1	-1	-1	-1	-1	-1	-1	-1	-1	-1	-1	-1	-1	-1	-1	33	80	3	81	3	3	3	11	-1	-1	-1	-1	-1	-1	-1	-1	-1	-1	-1	-1	-1	-1	-1	-1	-1	-1	-1	-1	-1	-1	-1	-1	-1	-1	-1	-1	-1	-1	-1	-1	-1	-1	-1	-1	-1	-1	-1	-1	
-1	-1	-1	-1	-1	-1	-1	-1	-1	-1	-1	-1	-1	-1	-1	-1	-1	-1	-1	-1	-1	-1	-1	-1	-1	-1	-1	-1	-1	-1	-1	-1	-1	-1	-1	-1	-1	-1	-1	-1	-1	-1	-1	-1	-1	-1	-1	-1	-1	-1	-1	-1	-1	-1	-1	-1	-1	-1	-1	-1	-1	-1	-1	-1	-1	-1	-1	-1	-1	-1	-1	-1	33	80	3	86	3	3	3	11	-1	-1	-1	-1	-1	-1	-1	-1	-1	-1	-1	-1	-1	-1	-1	-1	-1	-1	-1	-1	-1	-1	-1	-1	-1	-1	-1	-1	-1	-1	-1	-1	-1	-1	-1	-1	-1	-1	-1	-1	
-1	-1	-1	-1	-1	-1	-1	-1	-1	-1	-1	-1	-1	-1	-1	-1	-1	-1	-1	-1	-1	-1	-1	-1	-1	-1	-1	-1	-1	-1	-1	-1	-1	-1	-1	-1	-1	-1	-1	-1	-1	-1	-1	-1	-1	-1	-1	-1	-1	-1	-1	-1	-1	-1	-1	-1	-1	-1	-1	-1	-1	-1	-1	-1	-1	-1	-1	-1	-1	-1	-1	-1	33	80	3	15	15	15	66	103	-1	-1	-1	-1	-1	-1	-1	-1	-1	-1	-1	-1	-1	-1	-1	-1	-1	-1	-1	-1	-1	-1	-1	-1	-1	-1	-1	-1	-1	-1	-1	-1	-1	-1	-1	-1	-1	-1	-1	-1	
-1	-1	-1	-1	-1	-1	-1	-1	-1	-1	-1	-1	-1	-1	-1	-1	-1	-1	-1	-1	-1	-1	-1	-1	-1	-1	-1	-1	-1	-1	-1	-1	-1	-1	-1	-1	-1	-1	-1	-1	-1	-1	-1	-1	-1	-1	-1	-1	-1	-1	-1	-1	-1	-1	-1	-1	-1	-1	-1	-1	-1	-1	-1	-1	-1	-1	-1	-1	-1	-1	-1	-1	33	80	3	22	22	22	22	32	-1	-1	-1	-1	-1	-1	-1	-1	-1	-1	-1	-1	-1	-1	-1	-1	-1	-1	-1	-1	-1	-1	-1	-1	-1	-1	-1	-1	-1	-1	-1	-1	-1	-1	-1	-1	-1	-1	-1	-1	
-1	-1	-1	-1	-1	-1	-1	-1	-1	-1	-1	-1	-1	-1	-1	-1	-1	-1	-1	-1	-1	-1	-1	-1	-1	-1	-1	-1	-1	-1	-1	-1	-1	-1	-1	-1	-1	-1	-1	-1	-1	-1	-1	-1	-1	-1	-1	-1	-1	-1	-1	-1	-1	-1	-1	-1	-1	-1	-1	-1	-1	-1	-1	-1	-1	-1	-1	-1	-1	-1	-1	-1	104	80	3	105	105	105	105	105	106	106	107	108	108	108	109	110	111	111	111	111	111	111	111	111	111	111	111	111	111	111	111	111	111	111	111	111	111	111	111	111	112	113	113	113	113	113	113	114	
-1	-1	-1	-1	-1	-1	-1	-1	-1	-1	-1	-1	-1	-1	-1	-1	-1	-1	-1	-1	-1	-1	-1	-1	-1	-1	-1	-1	-1	-1	-1	-1	-1	-1	-1	-1	-1	-1	-1	-1	-1	-1	-1	-1	-1	-1	-1	-1	-1	-1	-1	-1	-1	-1	-1	-1	-1	-1	-1	-1	-1	-1	-1	-1	-1	-1	-1	-1	-1	-1	-1	-1	79	80	3	3	3	3	3	3	3	3	115	116	116	116	117	118	119	119	119	119	119	119	119	119	119	119	119	119	119	119	119	119	119	119	119	119	119	119	119	119	120	121	121	121	121	121	121	122	
-1	-1	-1	-1	-1	-1	-1	-1	-1	-1	-1	-1	-1	-1	-1	-1	-1	-1	-1	-1	-1	-1	-1	-1	-1	-1	-1	-1	-1	-1	-1	-1	-1	-1	-1	-1	-1	-1	-1	-1	-1	-1	-1	-1	-1	-1	-1	-1	-1	-1	-1	-1	-1	-1	-1	-1	-1	-1	-1	-1	-1	-1	-1	-1	-1	-1	-1	-1	-1	-1	-1	-1	79	80	3	3	3	3	123	124	125	126	116	116	116	116	117	127	128	128	128	128	128	128	128	128	128	128	128	128	128	128	128	128	128	128	128	128	129	128	128	128	120	121	121	121	121	121	121	122	
-1	-1	-1	-1	-1	-1	-1	-1	-1	-1	-1	-1	-1	-1	-1	-1	-1	-1	-1	-1	-1	-1	-1	-1	-1	-1	-1	-1	-1	-1	-1	-1	-1	-1	-1	-1	-1	-1	-1	-1	-1	-1	-1	-1	-1	-1	-1	-1	-1	-1	-1	-1	-1	-1	-1	-1	-1	-1	-1	-1	-1	-1	-1	-1	-1	-1	-1	-1	-1	-1	-1	-1	92	130	3	3	3	131	115	116	132	133	116	116	134	116	135	136	137	137	137	137	137	137	137	137	137	137	137	137	137	137	137	137	137	137	137	137	137	137	137	137	138	121	121	121	121	121	121	122	
-1	-1	-1	-1	-1	-1	-1	-1	-1	-1	-1	-1	-1	-1	-1	-1	-1	-1	-1	-1	-1	-1	-1	-1	-1	-1	-1	-1	-1	-1	-1	-1	-1	-1	-1	-1	-1	-1	-1	-1	-1	-1	-1	-1	-1	-1	-1	-1	-1	-1	-1	-1	-1	-1	-1	-1	-1	-1	-1	-1	-1	-1	-1	-1	-1	-1	-1	-1	-1	-1	-1	-1	139	92	140	141	3	142	116	116	143	144	145	146	147	146	116	148	121	121	121	121	121	121	121	121	121	121	121	121	121	121	121	121	121	121	121	121	121	121	121	121	121	121	121	121	121	121	121	122	
-1	-1	-1	-1	-1	-1	-1	-1	-1	-1	-1	-1	-1	-1	-1	-1	-1	-1	-1	-1	-1	-1	-1	-1	-1	-1	-1	-1	-1	-1	-1	-1	-1	-1	-1	-1	-1	-1	-1	-1	-1	-1	-1	-1	-1	-1	-1	-1	-1	-1	-1	-1	-1	-1	-1	-1	-1	-1	-1	-1	-1	-1	-1	-1	-1	-1	-1	-1	-1	-1	-1	-1	139	139	139	92	140	149	116	116	150	151	152	153	116	154	155	156	157	157	157	157	157	157	157	157	157	157	157	157	157	157	158	159	157	157	157	157	157	157	157	157	160	161	161	121	121	121	121	122	
-1	-1	-1	-1	-1	-1	-1	-1	-1	-1	-1	-1	-1	-1	-1	-1	-1	-1	-1	-1	-1	-1	-1	-1	-1	-1	-1	-1	-1	-1	-1	-1	-1	-1	-1	-1	-1	-1	-1	-1	-1	-1	-1	-1	-1	-1	-1	-1	-1	-1	-1	-1	-1	-1	-1	-1	-1	-1	-1	-1	-1	-1	-1	-1	-1	-1	-1	-1	-1	-1	-1	-1	139	139	139	139	139	92	155	155	162	163	163	163	155	139	139	139	164	164	164	164	164	164	164	164	164	164	164	164	164	164	164	164	164	164	164	164	164	164	164	164	92	165	165	157	157	157	157	166	
-1	-1	-1	-1	-1	-1	-1	-1	-1	-1	-1	-1	-1	-1	-1	-1	-1	-1	-1	-1	-1	-1	-1	-1	-1	-1	-1	-1	-1	-1	-1	-1	-1	-1	-1	-1	-1	-1	-1	-1	-1	-1	-1	-1	-1	-1	-1	-1	-1	-1	-1	-1	-1	-1	-1	-1	-1	-1	-1	-1	-1	-1	-1	-1	-1	-1	-1	-1	-1	-1	-1	-1	167	167	167	167	167	167	167	167	167	167	167	167	167	167	167	167	168	168	168	168	168	168	168	168	168	168	168	168	168	168	168	168	168	168	168	168	168	168	168	168	167	167	167	167	167	167	167	167	
#Tile_Matrix_End
#Objects
ObjCount
139
ObjID	TypeID	PosX	PosY	Width	Height	PosXCollide	PosYCollide	WidthCollide	HeightCollide
1	340	128	1072	8	8	124	1076	8	8
2	340	2432	1072	8	8	2428	1076	8	8
6	22	96	992	192	16	0	1000	192	16
7	22	199	1009	16	16	191	1017	16	16
9	22	208	1024	32	16	192	1032	32	16
10	22	272	1056	96	16	224	1064	96	16
11	22	352	1088	64	16	320	1096	64	16
12	22	432	1120	96	16	384	1128	96	16
13	22	232	1041	16	16	224	1049	16	16
14	22	328	1072	16	16	320	1080	16	16
15	22	392	1104	16	16	384	1112	16	16
16	22	1328	992	288	16	1184	1000	288	16
17	22	1488	1024	32	16	1472	1032	32	16
18	22	1552	1056	96	16	1504	1064	96	16
19	22	1616	1089	32	16	1600	1097	32	16
22	22	1647	1120	33	16	1631	1128	33	16
23	22	1680	1089	32	16	1664	1097	32	16
24	22	1712	1057	32	16	1696	1065	32	16
25	22	1744	1088	32	16	1728	1096	32	16
26	22	1776	1121	32	16	1760	1129	32	16
27	22	1480	1008	16	16	1472	1016	16	16
28	22	1512	1039	16	16	1352	1133	397	138
29	22	1608	1072	16	16	1600	1080	16	16
30	22	1640	1104	16	16	1632	1112	16	16
31	22	1656	1105	16	16	1648	1113	16	16
33	22	1687	1073	16	16	1679	1081	16	16
34	22	1736	1072	16	16	1728	1080	16	16
35	22	1768	1104	16	16	1760	1112	16	16
36	22	1785	1048	16	128	1777	1112	16	128
38	22	1889	993	192	16	1793	1001	192	16
39	22	1993	1008	16	16	1985	1016	16	16
40	22	2000	1024	33	16	1984	1032	33	16
41	22	2120	1056	209	16	2016	1064	209	16
42	22	2272	1056	32	16	2256	1064	32	16
44	22	2504	1024	16	16	2496	1032	16	16
45	22	2025	1039	16	16	2017	1047	16	16
47	22	2201	1004	16	87	2193	1047	16	87
49	22	2265	1005	16	89	2257	1049	16	89
51	22	2488	1001	16	97	2480	1049	16	97
54	22	2328	896	16	112	2320	952	16	112
55	22	2352	832	29	16	2338	840	29	16
59	22	2537	732	16	874	2529	1169	16	874
60	22	2424	744	16	195	2416	841	16	195
64	22	2408	745	16	193	2400	841	16	193
65	22	2359	737	16	177	2351	825	16	177
66	22	2345	656	16	16	2337	664	16	16
67	22	2327	624	16	48	2319	648	16	48
68	22	2489	728	16	160	2481	808	16	160
70	22	2473	726	16	162	2465	807	16	162
71	22	2471	600	16	66	2463	633	16	66
72	22	2488	600	16	65	2480	632	16	65
73	22	2352	592	30	16	2337	600	30	16
81	22	2424	505	16	97	2416	553	16	97
83	22	2488	489	16	65	2480	521	16	65
84	22	2472	489	16	65	2464	521	16	65
85	22	2327	424	16	64	2319	456	16	64
86	22	2423	369	16	83	2415	410	16	83
87	22	2408	369	16	82	2400	410	16	82
88	22	2366	464	97	16	2318	472	97	16
90	22	2472	288	144	16	2400	296	144	16
91	22	2360	249	16	257	2352	377	16	257
93	22	2408	264	16	32	2400	280	16	32
94	22	2488	256	144	16	2416	264	144	16
95	22	2400	112	64	16	2368	120	64	16
96	22	2464	80	64	16	2432	88	64	16
97	22	2488	64	16	16	2480	72	16	16
98	22	2608	48	224	16	2496	56	224	16
99	22	3169	80	898	16	2720	88	898	16
100	22	3183	160	834	16	2766	168	834	16
101	22	3611	64	16	16	3603	72	16	16
103	22	3721	48	239	16	3602	56	239	16
104	22	2776	206	16	68	2768	240	16	68
105	22	3592	205	16	76	3584	243	16	76
107	22	3832	148	16	184	3824	240	16	184
108	22	2424	96	16	16	2416	104	16	16
109	22	2399	959	160	16	2319	967	160	16
121	30	2311	975	16	16	2303	983	16	16
122	30	2327	975	16	16	2319	983	16	16
123	30	2342	975	16	16	2334	983	16	16
124	30	2376	975	16	16	2368	983	16	16
125	30	2409	975	16	16	2401	983	16	16
126	30	2424	975	16	16	2416	983	16	16
127	30	2439	975	16	16	2431	983	16	16
128	22	2416	1056	165	16	2334	1064	165	16
129	22	2521	960	16	16	2513	968	16	16
133	30	2504	304	16	16	2496	312	16	16
134	30	2519	304	16	16	2511	312	16	16
149	22	2480	817	34	16	2463	825	34	16
153	22	2416	849	34	16	2399	857	34	16
154	340	2432	952	8	8	2428	956	8	8
155	340	2432	728	8	8	2428	732	8	8
156	340	2432	504	8	8	2428	508	8	8
157	340	2432	250	8	8	2428	254	8	8
158	340	2432	129	8	8	2428	122	8	8
161	22	2343	384	50	16	2318	392	50	16
163	22	2415	418	33	16	2399	426	33	16
164	22	2480	529	34	16	2463	537	34	16
165	22	2415	561	33	16	2399	569	33	16
169	15	1414	1109	16	20	1352	1133	397	138
170	15	1510	1041	16	20	1352	1133	397	138
171	15	1584	1108	16	20	1352	1133	397	138
180	15	2341	871	16	20	2277	914	123	131
181	15	2314	797	16	20	2277	914	123	131
182	15	2325	624	16	20	2317	634	16	20
187	542	2801	120	32	64	2785	152	32	64
188	546	3586	121	32	64	3570	153	32	64
189	5001	3790	72	36	32	3601	240	223	183
190	60	3636	72	32	32	3620	88	32	32
191	60	3668	72	32	32	3652	88	32	32
193	25	2453	303	14	16	2446	311	14	16
197	19	2976	95	18	15	2831	150	736	63
198	19	3151	96	18	15	2831	150	736	63
199	19	3303	96	18	15	2831	150	736	63
200	19	3454	96	18	15	2831	150	736	63
206	19	368	1103	18	15	253	1130	187	105
207	19	293	1072	18	15	253	1130	187	105
213	19	208	1041	18	15	17	1074	227	106
214	25	1711	1075	14	16	1700	1094	26	37
217	20	2555	81	32	48	2369	239	412	197
220	36	873	1056	16	10	630	1085	274	53
221	36	745	1056	16	10	630	1085	274	53
222	36	1081	993	16	10	757	1019	358	47
223	36	1017	993	16	10	757	1019	358	47
224	36	953	993	16	10	757	1019	358	47
225	36	889	992	16	10	757	1019	358	47
226	36	825	992	16	10	757	1019	358	47
231	22	822	972	667	16	489	980	667	16
236	21	2164	1075	32	24	2147	1111	34	66
237	21	2272	1077	32	24	2253	1113	38	76
238	21	2481	1078	32	24	2461	1114	38	64
240	341	125	1014	16	16	117	1022	16	16
241	21	1913	1012	32	24	1894	1057	37	76
242	341	1827	1045	16	16	1819	1053	16	16
244	341	2893	96	16	16	2885	104	16	16
245	340	2813	129	8	8	3722	135	8	8
246	340	3712	129	8	8	2763	134	8	8
250	38	1107	990	32	28	758	1009	379	35
251	38	907	1054	32	28	631	1072	299	37
252	38	638	1118	32	28	502	1142	298	43
#Objects_End
#Quadtree_Collision
NodeCount
81
NodeID	PosX	PosY	Width	Height	ObjectsCount	ObjectIDs
0	0	3840	3840	3840	0
1	0	3840	1920	1920	0
2	1920	3840	1920	1920	0
3	0	1920	1920	1920	0
13	0	1920	960	960	0
53	0	1920	480	480	0
54	480	1920	480	480	0
55	0	1440	480	480	0
221	0	1440	240	240	0
222	240	1440	240	240	0
223	0	1200	240	240	7	6	7	9	10	13	213	240
224	240	1200	240	240	9	10	11	12	13	14	15	206	207	213
56	480	1440	480	480	0
225	480	1440	240	240	0
226	720	1440	240	240	0
227	480	1200	240	240	6	12	220	221	231	251	252
228	720	1200	240	240	11	220	221	222	223	224	225	226	231	250	251	252
14	960	1920	960	960	0
57	960	1920	480	480	0
58	1440	1920	480	480	0
59	960	1440	480	480	0
237	960	1440	240	240	0
238	1200	1440	240	240	0
239	960	1200	240	240	8	16	222	223	224	225	226	231	250
240	1200	1200	240	240	5	16	28	169	170	171
60	1440	1440	480	480	0
241	1440	1440	240	240	0
242	1680	1440	240	240	0
243	1440	1200	240	240	15	16	17	18	19	22	23	27	28	29	30	31	33	169	170	171
244	1680	1200	240	240	16	23	24	25	26	28	33	34	35	36	38	169	170	171	214	241	242
15	0	960	960	960	0
16	960	960	960	960	0
4	1920	1920	1920	1920	0
17	1920	1920	960	960	0
69	1920	1920	480	480	0
70	2400	1920	480	480	0
71	1920	1440	480	480	0
285	1920	1440	240	240	0
286	2160	1440	240	240	0
287	1920	1200	240	240	7	38	39	40	41	45	236	241
288	2160	1200	240	240	12	41	42	47	49	109	121	122	123	124	128	236	237
72	2400	1440	480	480	0
289	2400	1440	240	240	0
290	2640	1440	240	240	0
291	2400	1200	240	240	10	44	51	59	109	125	126	127	128	129	238
292	2640	1200	240	240	0
18	2880	1920	960	960	0
19	1920	960	960	960	0
77	1920	960	480	480	0
309	1920	960	240	240	0
310	2160	960	240	240	10	47	49	54	55	64	65	109	153	180	181
311	1920	720	240	240	0
312	2160	720	240	240	7	64	65	66	67	73	165	182
78	2400	960	480	480	0
313	2400	960	240	240	12	51	59	60	64	68	70	109	129	149	153	180	181
314	2640	960	240	240	0
315	2400	720	240	240	12	59	60	64	68	70	71	72	81	83	84	164	165
316	2640	720	240	240	0
79	1920	480	480	480	0
317	1920	480	240	240	0
318	2160	480	240	240	8	85	87	88	90	91	93	161	163
319	1920	240	240	240	0
320	2160	240	240	240	3	91	95	217
80	2400	480	480	480	0
321	2400	480	240	240	14	59	81	83	84	86	87	88	90	93	94	133	134	163	193
322	2640	480	240	240	1	104
323	2400	240	240	240	6	95	96	97	98	108	217
324	2640	240	240	240	10	98	99	100	104	187	197	198	199	200	217
20	2880	960	960	960	0
81	2880	960	480	480	0
82	3360	960	480	480	0
83	2880	480	480	480	0
333	2880	480	240	240	0
334	3120	480	240	240	0
335	2880	240	240	240	7	99	100	197	198	199	200	244
336	3120	240	240	240	6	99	100	197	198	199	200
84	3360	480	480	480	0
337	3360	480	240	240	1	105
338	3600	480	240	240	3	105	107	189
339	3360	240	240	240	8	99	100	105	188	197	198	199	200
340	3600	240	240	240	10	99	100	101	103	105	107	188	189	190	191
#Quadtree_Collision_End
#Camera_Path_Point
9
128	1072
2432	1072
2432	952
2432	728
2432	504
2432	250
2432	129
2813	129
3712	129
#Camera_Path_Point_End
